,dividends,original_filing_date,period_end_date,period_end_price,shares_eop,cogs,da_income_statement_supplemental,eps_basic,eps_diluted,gross_profit,income_allocated_to_minority_interest,income_tax,interest_expense,interest_income,net_income,net_income_available_to_shareholders,net_income_continuing,net_income_discontinued,net_interest_income_normal,operating_income,other_income_statement_items,other_nonoperating_income,other_opex,preferred_dividends,pretax_income,revenue,rnd,sga,shares_basic,shares_diluted,special_charges,total_opex,fiscal_quarter_key,fiscal_quarter_number
0,0.0,2002-02-11,2001-12,0.39,19737720000,953000000,28000000,0.0,0.0,422000000,0,-15000000,-3000000,34000000,38000000,38000000,38000000,0,31000000,20000000,0,2000000,0,0,53000000,1375000000,113000000,289000000,19674480000,20020504000,0,402000000,FY2002.FQ1,1
1,0.0,2002-05-14,2002-03,0.42,19828769000,1086000000,29000000,0.0,0.0,409000000,0,-15000000,-3000000,29000000,40000000,40000000,40000000,0,26000000,28000000,0,1000000,0,0,55000000,1495000000,111000000,270000000,19794880000,20494264000,0,381000000,FY2002.FQ2,2
2,0.0,2002-08-09,2002-06,0.32,20095896000,1038000000,28000000,0.0,0.0,391000000,0,-7000000,-2000000,29000000,32000000,32000000,32000000,0,27000000,13000000,0,-1000000,0,0,39000000,1429000000,106000000,272000000,19956720000,20545392000,0,378000000,FY2002.FQ3,3
3,0.0,2002-12-19,2002-09,0.26,20101703000,1062000000,29000000,0.0,0.0,381000000,0,15000000,-3000000,26000000,-45000000,-45000000,-45000000,0,23000000,-14000000,0,-69000000,0,0,-60000000,1443000000,117000000,278000000,20086528000,20086528000,0,395000000,FY2002.FQ4,4
4,0.0,2003-02-10,2002-12,0.26,20174405000,1066000000,31000000,0.0,0.0,406000000,0,2000000,-2000000,23000000,-8000000,-8000000,-6000000,0,21000000,-14000000,-2000000,-15000000,0,0,-8000000,1472000000,121000000,299000000,20107192000,20107192000,0,420000000,FY2003.FQ1,1
5,0.0,2003-05-13,2003-03,0.25,20470535000,1057000000,29000000,0.0,0.0,418000000,0,-5000000,-2000000,18000000,14000000,14000000,14000000,0,16000000,-1000000,0,4000000,0,0,19000000,1475000000,119000000,300000000,20187440000,20285608000,0,419000000,FY2003.FQ2,2
6,0.0,2003-08-12,2003-06,0.34,20551587000,1117000000,24000000,0.0,0.0,428000000,0,-7000000,-2000000,15000000,19000000,19000000,19000000,0,13000000,9000000,0,4000000,0,0,26000000,1545000000,120000000,299000000,20204408000,20371512000,0,419000000,FY2003.FQ3,3
7,0.0,2003-12-19,2003-09,0.37,20536689000,1259000000,29000000,0.0,0.0,456000000,0,-14000000,20000000,13000000,44000000,44000000,41000000,0,33000000,31000000,3000000,-9000000,0,0,55000000,1715000000,111000000,314000000,20282360000,20529656000,0,425000000,FY2003.FQ4,4
8,0.0,2004-02-10,2003-12,0.38,20650613000,1470000000,33000000,0.0,0.0,536000000,0,-24000000,-2000000,14000000,63000000,63000000,63000000,0,12000000,74000000,0,1000000,0,0,87000000,2006000000,119000000,343000000,20297200000,20849248000,0,462000000,FY2004.FQ1,1
9,0.0,2004-05-06,2004-03,0.48,20879899000,1379000000,36000000,0.0,0.0,530000000,0,-18000000,12000000,0,46000000,46000000,46000000,0,12000000,62000000,0,-10000000,0,0,64000000,1909000000,123000000,345000000,20459432000,21180880000,0,468000000,FY2004.FQ2,2
10,0.0,2004-08-05,2004-06,0.58,21570768000,1455000000,41000000,0.0,0.0,559000000,0,-24000000,13000000,0,61000000,61000000,61000000,0,13000000,80000000,0,-8000000,0,0,85000000,2014000000,125000000,354000000,21001288000,21986776000,0,479000000,FY2004.FQ3,3
11,0.0,2004-12-03,2004-09,0.69,21920843000,1718000000,40000000,0.0,0.0,632000000,0,-38000000,27000000,0,96000000,96000000,96000000,0,27000000,120000000,0,-13000000,0,0,134000000,2350000000,124000000,388000000,21478352000,22723400000,0,512000000,FY2004.FQ4,4
12,0.0,2005-02-01,2004-12,1.15,22654745000,2494000000,41000000,0.01,0.01,996000000,0,-134000000,0,28000000,295000000,295000000,295000000,0,28000000,403000000,0,-2000000,0,0,429000000,3490000000,123000000,470000000,22092896000,23468872000,0,593000000,FY2005.FQ1,1
13,0.0,2005-05-04,2005-03,1.49,23047829000,2275000000,41000000,0.01,0.01,968000000,0,-145000000,0,39000000,290000000,290000000,290000000,0,39000000,402000000,0,-6000000,0,0,435000000,3243000000,119000000,447000000,22628816000,23996308000,0,566000000,FY2005.FQ2,2
14,0.0,2005-08-03,2005-06,1.31,23183473000,2476000000,46000000,0.01,0.01,1044000000,0,-153000000,0,51000000,319000000,319000000,319000000,0,51000000,426000000,0,-5000000,0,0,472000000,3520000000,145000000,473000000,22822576000,24102484000,0,618000000,FY2005.FQ3,3
15,0.0,2005-12-01,2005-09,1.91,23380542000,2643000000,51000000,0.01,0.01,1035000000,0,-49000000,0,65000000,428000000,428000000,428000000,0,65000000,417000000,0,-5000000,0,0,477000000,3678000000,147000000,471000000,23000936000,24298344000,0,618000000,FY2005.FQ4,4
16,0.0,2006-02-03,2005-12,2.57,23677281000,4185000000,52000000,0.02,0.02,1564000000,0,-266000000,0,88000000,565000000,565000000,565000000,0,88000000,750000000,0,-7000000,0,0,831000000,5749000000,182000000,632000000,23261868000,24477796000,0,814000000,FY2006.FQ1,1
17,0.0,2006-05-05,2006-03,2.24,23777268000,3062000000,50000000,0.01,0.01,1297000000,0,-195000000,0,87000000,410000000,410000000,410000000,0,87000000,529000000,0,-11000000,0,0,605000000,4359000000,176000000,592000000,23545480000,24599036000,0,768000000,FY2006.FQ2,2
18,0.0,2006-12-29,2006-06,2.05,23883654000,3045000000,57000000,0.02,0.01,1325000000,0,-189000000,0,99000000,472000000,472000000,472000000,0,99000000,566000000,0,-4000000,0,0,661000000,4370000000,175000000,584000000,23838500000,24538304000,0,759000000,FY2006.FQ3,3
19,0.0,2006-12-29,2006-09,2.75,23947352000,3425000000,66000000,0.02,0.02,1412000000,0,-179000000,0,120000000,542000000,542000000,542000000,0,120000000,608000000,0,-7000000,0,0,721000000,4837000000,179000000,625000000,23910740000,24617348000,0,804000000,FY2006.FQ4,4
20,0.0,2007-02-02,2006-12,3.03,24086157000,4895000000,74000000,0.04,0.04,2220000000,0,-444000000,0,0,1004000000,1004000000,1004000000,0,0,1322000000,0,126000000,0,0,1448000000,7115000000,184000000,714000000,24015348000,24732316000,0,898000000,FY2007.FQ1,1
21,0.0,2007-05-10,2007-03,3.32,24218545000,3415000000,69000000,0.03,0.03,1849000000,0,-364000000,0,0,770000000,770000000,770000000,0,0,986000000,0,148000000,0,0,1134000000,5264000000,183000000,680000000,24164084000,24826284000,0,863000000,FY2007.FQ2,2
22,0.0,2007-08-08,2007-06,4.36,24349947000,3415000000,81000000,0.03,0.03,1995000000,0,-378000000,0,0,818000000,818000000,818000000,0,0,1041000000,0,155000000,0,0,1196000000,5410000000,208000000,746000000,24270568000,24938788000,0,954000000,FY2007.FQ3,3
23,0.0,2007-11-15,2007-09,5.48,24425211000,4701000000,93000000,0.03,0.03,2088000000,0,-325000000,0,0,903000000,903000000,903000000,0,0,1058000000,0,170000000,0,0,1228000000,6789000000,207000000,823000000,24384640000,25084724000,0,1030000000,FY2007.FQ4,4
24,0.0,2008-02-01,2007-12,7.07,24601608000,6276000000,106000000,0.06,0.06,3332000000,0,-745000000,0,0,1581000000,1581000000,1581000000,0,0,2126000000,0,200000000,0,0,2326000000,9608000000,246000000,960000000,24524080000,25201512000,0,1206000000,FY2008.FQ1,1
25,0.0,2008-05-01,2008-03,5.13,24680068000,5038000000,116000000,0.04,0.04,2474000000,0,-432000000,0,0,1045000000,1045000000,1045000000,0,0,1315000000,0,162000000,0,0,1477000000,7512000000,273000000,886000000,24627288000,25181212000,0,1159000000,FY2008.FQ2,2
26,0.0,2008-07-23,2008-06,5.98,24800906000,4864000000,117000000,0.04,0.04,2600000000,0,-438000000,0,0,1072000000,1072000000,1072000000,0,0,1392000000,0,118000000,0,0,1510000000,7464000000,292000000,916000000,24744664000,25288676000,0,1208000000,FY2008.FQ3,3
27,0.0,2008-11-05,2008-09,4.06,24890183000,8116000000,157000000,0.09,0.09,4791000000,0,-1213000000,0,0,2421000000,2421000000,2421000000,0,0,3494000000,0,140000000,0,0,3634000000,12907000000,298000000,999000000,24839052000,25353216000,0,1297000000,FY2008.FQ4,4
28,0.0,2009-01-23,2008-12,3.05,24931618000,7373000000,168000000,0.09,0.08,4507000000,0,-1004000000,0,0,2255000000,2255000000,2255000000,0,0,3101000000,0,158000000,0,0,3259000000,11880000000,315000000,1091000000,24895976000,25241832000,0,1406000000,FY2009.FQ1,1
29,0.0,2009-04-23,2009-03,3.75,24979075000,5457000000,181000000,0.06,0.06,3627000000,0,-766000000,0,0,1620000000,1620000000,1620000000,0,0,2323000000,0,63000000,0,0,2386000000,9084000000,319000000,985000000,24953040000,25283804000,0,1304000000,FY2009.FQ2,2
30,0.0,2009-07-22,2009-06,5.09,25080586000,5751000000,182000000,0.07,0.07,3983000000,0,-864000000,0,0,1828000000,1828000000,1828000000,0,0,2632000000,0,60000000,0,0,2692000000,9734000000,341000000,1010000000,25023936000,25456480000,0,1351000000,FY2009.FQ3,3
31,0.0,2009-10-27,2009-09,6.62,25194554000,7102000000,203000000,0.06,0.06,5105000000,0,-1197000000,0,0,2532000000,2532000000,2532000000,0,0,3684000000,0,45000000,0,0,3729000000,12207000000,358000000,1063000000,25144812000,25602444000,0,1421000000,FY2009.FQ4,4
32,0.0,2010-01-25,2009-12,7.53,25375901000,9272000000,209000000,0.13,0.13,6411000000,0,-1380000000,0,0,3378000000,3378000000,3378000000,0,0,4725000000,0,33000000,0,0,4758000000,15683000000,398000000,1288000000,25299176000,25753924000,0,1686000000,FY2010.FQ1,1
33,0.0,2010-04-21,2010-03,8.39,25469803000,7874000000,216000000,0.12,0.11,5625000000,0,-955000000,0,0,3074000000,3074000000,3074000000,0,0,3979000000,0,50000000,0,0,4029000000,13499000000,426000000,1220000000,25411344000,25840584000,0,1646000000,FY2010.FQ2,2
34,0.0,2010-07-21,2010-06,8.98,25577506000,9564000000,273000000,0.12,0.12,6136000000,0,-1039000000,0,0,3253000000,3253000000,3253000000,0,0,4234000000,0,58000000,0,0,4292000000,15700000000,464000000,1438000000,25541516000,25966108000,0,1902000000,FY2010.FQ3,3
35,0.0,2010-10-27,2010-09,10.13,25647161000,12831000000,329000000,0.16,0.16,7512000000,0,-1153000000,0,0,4308000000,4308000000,4308000000,0,0,5447000000,0,14000000,0,0,5461000000,20343000000,494000000,1571000000,25607624000,26007100000,0,2065000000,FY2010.FQ4,4
36,0.0,2011-01-19,2010-12,11.52,25789219000,16443000000,356000000,0.23,0.23,10298000000,0,-1959000000,0,0,6004000000,6004000000,6004000000,0,0,7827000000,0,136000000,0,0,7963000000,26741000000,575000000,1896000000,25740232000,26128312000,0,2471000000,FY2011.FQ1,1
37,0.0,2011-04-21,2011-03,12.45,25890874000,14449000000,434000000,0.23,0.22,10218000000,0,-1913000000,0,0,5987000000,5987000000,5987000000,0,0,7874000000,0,26000000,0,0,7900000000,24667000000,581000000,1763000000,25849488000,26206432000,0,2344000000,FY2011.FQ2,2
38,0.0,2011-07-20,2011-06,11.99,25953306000,16649000000,481000000,0.28,0.27,11922000000,0,-2243000000,0,0,7308000000,7308000000,7308000000,0,0,9379000000,0,172000000,0,0,9551000000,28571000000,628000000,1915000000,25931024000,26258680000,0,2543000000,FY2011.FQ3,3
39,0.0,2011-10-26,2011-09,13.62,26019756000,16890000000,543000000,0.25,0.25,11380000000,0,-2168000000,0,0,6623000000,6623000000,6623000000,0,0,8710000000,0,81000000,0,0,8791000000,28270000000,645000000,2025000000,25991868000,26306448000,0,2670000000,FY2011.FQ4,4
40,0.0,2012-01-25,2011-12,14.46,26101992000,25630000000,721000000,0.5,0.49,20703000000,0,-4413000000,0,228000000,13064000000,13064000000,13064000000,0,228000000,17340000000,0,-91000000,0,0,17477000000,46333000000,758000000,2605000000,26069148000,26364016000,0,3363000000,FY2012.FQ1,1
41,0.0,2012-04-25,2012-03,21.41,26179496000,20622000000,740000000,0.44,0.43,18564000000,0,-3910000000,0,254000000,11622000000,11622000000,11622000000,0,254000000,15384000000,0,-106000000,0,0,15532000000,39186000000,841000000,2339000000,26140296000,26457004000,0,3180000000,FY2012.FQ2,2
42,0.0,2012-07-25,2012-06,20.86,26243448000,20029000000,835000000,0.33,0.33,14994000000,0,-3037000000,0,292000000,8824000000,8824000000,8824000000,0,292000000,11573000000,0,-4000000,0,0,11861000000,35023000000,876000000,2545000000,26224688000,26517652000,0,3421000000,FY2012.FQ3,3
43,0.095,2012-10-31,2012-09,23.83,26297824000,21565000000,981000000,0.31,0.31,14401000000,0,-2670000000,0,314000000,8223000000,8223000000,8223000000,0,314000000,10944000000,0,-365000000,0,0,10893000000,35966000000,906000000,2551000000,26271168000,26546768000,0,3457000000,FY2012.FQ4,4
44,0.095,2013-01-24,2012-12,19.01,26291244000,33452000000,1588000000,0.49,0.49,21060000000,0,-4594000000,0,421000000,13078000000,13078000000,13078000000,0,421000000,17210000000,0,41000000,0,0,17672000000,54512000000,1010000000,2840000000,26289648000,26522076000,0,3850000000,FY2013.FQ1,1
45,0.095,2013-04-24,2013-03,15.81,26322632000,27254000000,1692000000,0.36,0.36,16349000000,0,-3358000000,0,420000000,9547000000,9547000000,9547000000,0,420000000,12558000000,0,-73000000,0,0,12905000000,43603000000,1119000000,2672000000,26309612000,26488980000,0,3791000000,FY2013.FQ2,2
46,0.109,2013-07-24,2013-06,14.16,25436376000,22299000000,1694000000,0.26,0.26,13024000000,0,-2535000000,-53000000,385000000,6900000000,6900000000,6900000000,0,332000000,9201000000,0,-98000000,0,0,9435000000,35323000000,1178000000,2645000000,25721292000,25879416000,0,3823000000,FY2013.FQ3,3
47,0.109,2013-10-30,2013-09,17.03,25177964000,23601000000,1783000000,0.29,0.29,13871000000,0,-2631000000,-83000000,390000000,7512000000,7512000000,7512000000,0,307000000,10030000000,0,-194000000,0,0,10143000000,37472000000,1168000000,2673000000,25316552000,25455684000,0,3841000000,FY2013.FQ4,4
48,0.109,2014-01-28,2013-12,20.04,24991511000,35748000000,2144000000,0.52,0.51,21846000000,0,-4637000000,-84000000,427000000,13072000000,13072000000,13072000000,0,343000000,17463000000,0,-97000000,0,0,17709000000,57594000000,1330000000,3053000000,25090016000,25240644000,0,4383000000,FY2014.FQ1,1
49,0.109,2014-04-24,2014-03,19.17,24128860000,27699000000,1887000000,0.41,0.41,17947000000,0,-3595000000,-85000000,410000000,10223000000,10223000000,10223000000,0,325000000,13593000000,0,-100000000,0,0,13818000000,45646000000,1422000000,2932000000,24493208000,24626796000,0,4354000000,FY2014.FQ2,2
50,0.118,2014-07-23,2014-06,23.23,23956684000,22697000000,1946000000,0.32,0.32,14735000000,0,-2736000000,-100000000,439000000,7748000000,7748000000,7748000000,0,339000000,10282000000,0,-137000000,0,0,10484000000,37432000000,1603000000,2850000000,24050540000,24206844000,0,4453000000,FY2014.FQ3,3
51,0.118,2014-10-27,2014-09,25.19,23464644000,26114000000,1969000000,0.35,0.35,16009000000,0,-3005000000,-115000000,519000000,8467000000,8467000000,8467000000,0,404000000,11165000000,0,-97000000,0,0,11472000000,42123000000,1686000000,3158000000,23735388000,23888324000,0,4844000000,FY2014.FQ4,4
52,0.118,2015-01-28,2014-12,27.6,23305676000,44858000000,2575000000,0.77,0.76,29741000000,0,-6392000000,-131000000,654000000,18024000000,18024000000,18024000000,0,523000000,24246000000,0,-353000000,0,0,24416000000,74599000000,1895000000,3600000000,23372328000,23527212000,0,5495000000,FY2015.FQ1,1
53,0.118,2015-04-28,2015-03,31.11,23049112000,34354000000,2479000000,0.58,0.58,23656000000,0,-4995000000,-163000000,675000000,13569000000,13569000000,13569000000,0,512000000,18278000000,0,-226000000,0,0,18564000000,58010000000,1918000000,3460000000,23175196000,23339432000,0,5378000000,FY2015.FQ2,2
54,0.13,2015-07-22,2015-06,31.36,22821600000,29924000000,3084000000,0.46,0.46,19681000000,0,-3796000000,-201000000,766000000,10677000000,10677000000,10677000000,0,565000000,14083000000,0,-175000000,0,0,14473000000,49605000000,2034000000,3564000000,22919544000,23092396000,0,5598000000,FY2015.FQ3,3
55,0.13,2015-10-28,2015-09,27.58,22315012000,30953000000,3119000000,0.49,0.49,20548000000,0,-3938000000,-238000000,826000000,11124000000,11124000000,11124000000,0,588000000,14623000000,0,-149000000,0,0,15062000000,51501000000,2220000000,3705000000,22587672000,22730064000,0,5925000000,FY2015.FQ4,4
56,0.13,2016-01-27,2015-12,26.32,22177948000,45449000000,2954000000,0.82,0.82,30423000000,0,-6212000000,-276000000,941000000,18361000000,18361000000,18361000000,0,665000000,24171000000,0,-263000000,0,0,24573000000,75872000000,2404000000,3848000000,22235720000,22376508000,0,6252000000,FY2016.FQ1,1
57,0.13,2016-04-27,2016-03,27.25,21913784000,30636000000,2477000000,0.47,0.47,19921000000,0,-3626000000,-321000000,986000000,10516000000,10516000000,10516000000,0,665000000,13987000000,0,-510000000,0,0,14142000000,50557000000,2511000000,3423000000,22057524000,22163544000,0,5934000000,FY2016.FQ2,2
58,0.143,2016-07-27,2016-06,23.9,21572660000,26252000000,2526000000,0.35,0.35,16106000000,0,-2673000000,-409000000,1036000000,7796000000,7796000000,7796000000,0,627000000,10105000000,0,-263000000,0,0,10469000000,42358000000,2560000000,3441000000,21772232000,21891124000,0,6001000000,FY2016.FQ3,3
59,0.143,2016-10-26,2016-09,28.26,21344664000,29039000000,2548000000,0.42,0.41,17813000000,0,-3174000000,-450000000,1036000000,9014000000,9014000000,9014000000,0,586000000,11761000000,0,-159000000,0,0,12188000000,46852000000,2570000000,3482000000,21467648000,21573324000,0,6052000000,FY2016.FQ4,4
60,0.143,2017-02-01,2016-12,28.96,21021692000,48175000000,2987000000,0.84,0.84,30176000000,0,-6289000000,-525000000,1224000000,17891000000,17891000000,17891000000,0,699000000,23359000000,0,122000000,0,0,24180000000,78351000000,2871000000,3946000000,21194644000,21311980000,0,6817000000,FY2017.FQ1,1
61,0.143,2017-05-03,2017-03,35.92,20823260000,32305000000,2332000000,0.52,0.52,20591000000,0,-3655000000,-530000000,1282000000,11029000000,11029000000,11029000000,0,752000000,14097000000,0,-165000000,0,0,14684000000,52896000000,2776000000,3718000000,20903164000,21046752000,0,6494000000,FY2017.FQ2,2
62,0.158,2017-08-02,2017-06,36.01,20679128000,27920000000,2354000000,0.42,0.41,17488000000,0,-2591000000,-602000000,1327000000,8717000000,8717000000,8717000000,0,725000000,10768000000,0,-185000000,0,0,11308000000,45408000000,2937000000,3783000000,20780352000,20933996000,0,6720000000,FY2017.FQ3,3
63,0.158,2017-11-03,2017-09,38.53,20504804000,32648000000,2484000000,0.52,0.51,19931000000,0,-3203000000,-666000000,1368000000,10714000000,10714000000,10714000000,0,702000000,13120000000,0,95000000,0,0,13917000000,52579000000,2997000000,3814000000,20597708000,20734344000,0,6811000000,FY2017.FQ4,4
64,0.158,2018-02-02,2017-12,42.31,20326604000,54381000000,2745000000,0.98,0.97,33912000000,0,-6965000000,-734000000,1452000000,20065000000,20065000000,20065000000,0,718000000,26274000000,0,38000000,0,0,27030000000,88293000000,3407000000,4231000000,20451508000,20631148000,0,7638000000,FY2018.FQ1,1
65,0.158,2018-05-02,2018-03,41.95,19773128000,37715000000,2739000000,0.68,0.68,23422000000,0,-2346000000,-792000000,1505000000,13822000000,13822000000,13822000000,0,713000000,15894000000,0,-439000000,0,0,16168000000,61137000000,3378000000,4150000000,20099508000,20273972000,0,7528000000,FY2018.FQ2,2
66,0.183,2018-08-01,2018-06,46.28,19371668000,32844000000,2665000000,0.59,0.58,20421000000,0,-1765000000,-846000000,1418000000,11519000000,11519000000,11519000000,0,572000000,12612000000,0,100000000,0,0,13284000000,53265000000,3701000000,4108000000,19528668000,19706436000,0,7809000000,FY2018.FQ3,3
67,0.183,2018-11-05,2018-09,56.44,19019944000,38816000000,2754000000,0.73,0.72,24084000000,0,-2296000000,-868000000,1311000000,14125000000,14125000000,14125000000,0,443000000,16118000000,0,-140000000,0,0,16421000000,62900000000,3750000000,4216000000,19206360000,19390184000,0,7966000000,FY2018.FQ4,4
68,0.183,2019-01-30,2018-12,39.44,18919212000,52279000000,3395000000,1.05,1.04,32031000000,0,-3941000000,-890000000,1307000000,19965000000,19965000000,19965000000,0,417000000,23346000000,0,143000000,0,0,23906000000,84310000000,3902000000,4783000000,18943280000,19093008000,0,8685000000,FY2019.FQ1,1
69,0.183,2019-05-01,2019-03,47.49,18429136000,36194000000,3040000000,0.61,0.61,21821000000,0,-2232000000,-1010000000,1358000000,11561000000,11561000000,11561000000,0,348000000,13415000000,0,30000000,0,0,13793000000,58015000000,3948000000,4458000000,18696284000,18802584000,0,8406000000,FY2019.FQ2,2
70,0.193,2019-07-31,2019-06,49.48,18125580000,33582000000,2933000000,0.55,0.54,20227000000,0,-1867000000,-866000000,1190000000,10044000000,10044000000,10044000000,0,324000000,11544000000,0,43000000,0,0,11911000000,53809000000,4257000000,4426000000,18282532000,18405520000,0,8683000000,FY2019.FQ3,3
71,0.193,2019-10-31,2019-09,55.99,17772944000,39727000000,3179000000,0.76,0.75,24313000000,0,-2441000000,-810000000,1106000000,13686000000,13686000000,13686000000,0,296000000,15625000000,0,206000000,0,0,16127000000,64040000000,4110000000,4578000000,17963244000,18081496000,0,8688000000,FY2019.FQ4,4
72,0.193,2020-01-29,2019-12,73.41,17536108000,56602000000,2816000000,1.26,1.25,35217000000,0,-3682000000,-785000000,1045000000,22236000000,22236000000,22236000000,0,260000000,25569000000,0,89000000,0,0,25918000000,91819000000,4451000000,5197000000,17660160000,17818417000,0,9648000000,FY2020.FQ1,1
73,0.193,2020-05-01,2020-03,63.573,17295948000,35943000000,2786000000,0.64,0.64,22370000000,0,-1886000000,-757000000,1049000000,11249000000,11249000000,11249000000,0,292000000,12853000000,0,-10000000,0,0,13135000000,58313000000,4565000000,4952000000,17440402000,17618765000,0,9517000000,FY2020.FQ2,2
74,0.205,2020-07-31,2020-06,91.2,17135756000,37005000000,2752000000,0.65,0.65,22680000000,0,-1884000000,-697000000,901000000,11253000000,11253000000,11253000000,0,204000000,13091000000,0,-158000000,0,0,13137000000,59685000000,4758000000,4831000000,17250291000,17419154000,0,9589000000,FY2020.FQ3,3
75,0.205,2020-10-30,2020-09,115.81,16976763000,40009000000,2702000000,0.74,0.73,24689000000,0,-2228000000,-634000000,768000000,12673000000,12673000000,12673000000,0,134000000,14775000000,0,-8000000,0,0,14901000000,64698000000,4978000000,4936000000,17057624000,17256522000,0,9914000000,FY2020.FQ4,4
76,0.205,2021-01-28,2020-12,132.69,16823263000,67111000000,2666000000,1.7,1.68,44328000000,0,-4824000000,-638000000,747000000,28755000000,28755000000,28755000000,0,109000000,33534000000,0,-64000000,0,0,33579000000,111439000000,5163000000,5631000000,16935119000,17113688000,0,10794000000,FY2021.FQ1,1
77,0.205,2021-04-29,2021-03,122.15,16686305000,51505000000,2797000000,1.41,1.4,38079000000,0,-4381000000,-670000000,718000000,23630000000,23630000000,23630000000,0,48000000,27503000000,0,460000000,0,0,28011000000,89584000000,5262000000,5314000000,16753476000,16929157000,0,10576000000,FY2021.FQ2,2
78,0.22,2021-07-28,2021-06,136.96,16556942000,46179000000,2832000000,1.31,1.3,35255000000,0,-2625000000,-665000000,719000000,21744000000,21744000000,21744000000,0,54000000,24126000000,0,189000000,0,0,24369000000,81434000000,5717000000,5412000000,16629371000,16781735000,0,11129000000,FY2021.FQ3,3
79,0.22,2021-10-29,2021-09,141.5,16426786000,48186000000,2989000000,1.25,1.24,35174000000,0,-2697000000,-672000000,659000000,20551000000,20551000000,20551000000,0,-13000000,23786000000,0,-525000000,0,0,23248000000,83360000000,5772000000,5616000000,16487120000,16635095000,0,11388000000,FY2021.FQ4,4
80,0.22,2022-01-28,2021-12,177.57,16334371000,69702000000,2697000000,2.11,2.1,54243000000,0,-6611000000,-694000000,650000000,34630000000,34630000000,34630000000,0,-44000000,41488000000,0,-203000000,0,0,41241000000,123945000000,6306000000,6449000000,16391724000,16519291000,0,12755000000,FY2022.FQ1,1
81,0.22,2022-04-29,2022-03,174.61,16207568000,54719000000,2737000000,1.54,1.52,42559000000,0,-5129000000,-691000000,700000000,25010000000,25010000000,25010000000,0,9000000,29979000000,0,151000000,0,0,30139000000,97278000000,6387000000,6193000000,16278802000,16403316000,0,12580000000,FY2022.FQ2,2
82,0.23,2022-07-29,2022-06,136.72,16095378000,47074000000,2805000000,1.2,1.2,35885000000,0,-3624000000,-719000000,722000000,19442000000,19442000000,19442000000,0,3000000,23076000000,0,-13000000,0,0,23066000000,82959000000,6797000000,6012000000,16162945000,16262203000,0,12809000000,FY2022.FQ3,3
83,0.23,2022-10-28,2022-09,138.2,15943425000,52051000000,2865000000,1.29,1.29,38095000000,0,-3936000000,-827000000,753000000,20721000000,20721000000,20721000000,0,-74000000,24894000000,0,-163000000,0,0,24657000000,90146000000,6761000000,6440000000,16030380000,16118465000,0,13201000000,FY2022.FQ4,4
84,0.23,2023-02-03,2022-12,129.93,15842407000,66822000000,2916000000,1.89,1.88,50332000000,0,-5625000000,0,0,29998000000,29998000000,29998000000,0,0,36016000000,0,-393000000,0,0,35623000000,117154000000,7709000000,6607000000,15892723000,15955718000,0,14316000000,FY2023.FQ1,1
85,0.23,2023-05-05,2023-03,164.9,15723406000,52860000000,2898000000,1.53,1.52,41976000000,0,-4222000000,0,0,24160000000,24160000000,24160000000,0,0,28318000000,0,64000000,0,0,28382000000,94836000000,7457000000,6201000000,15787154000,15847050000,0,13658000000,FY2023.FQ2,2
86,0.24,2023-08-04,2023-06,193.97,15647868000,45384000000,3052000000,1.27,1.26,36413000000,0,-2852000000,0,0,19881000000,19881000000,19881000000,0,0,22998000000,0,-265000000,0,0,22733000000,81797000000,7442000000,5973000000,15697614000,15775021000,0,13415000000,FY2023.FQ3,3
87,0.24,2023-11-03,2023-09,171.21,15550061000,49071000000,2653000000,1.47,1.46,40427000000,0,-4042000000,0,0,22956000000,22956000000,22956000000,0,0,26969000000,0,29000000,0,0,26998000000,89498000000,7307000000,6151000000,15599433000,15672399000,0,13458000000,FY2023.FQ4,4
88,0.24,2024-02-02,2023-12,192.53,15460223000,64720000000,2848000000,2.19,2.18,54855000000,0,-6407000000,0,0,33916000000,33916000000,33916000000,0,0,40373000000,0,-50000000,0,0,40323000000,119575000000,7696000000,6786000000,15509763000,15576641000,0,14482000000,FY2024.FQ1,1
89,0.24,2024-05-03,2024-03,171.48,15337686000,48482000000,2836000000,1.53,1.53,42271000000,0,-4422000000,0,0,23636000000,23636000000,23636000000,0,0,27900000000,0,158000000,0,0,28058000000,90753000000,7903000000,6468000000,15405856000,15464709000,0,14371000000,FY2024.FQ2,2
90,0.25,2024-08-02,2024-06,210.62,15222259000,46099000000,2850000000,1.4,1.4,39678000000,0,-4046000000,0,0,21448000000,21448000000,21448000000,0,0,25352000000,0,142000000,0,0,25494000000,85777000000,8006000000,6320000000,15287521000,15348175000,0,14326000000,FY2024.FQ3,3
91,0.25,2024-11-01,2024-09,233.0,15116786000,51051000000,2911000000,0.97,0.97,43879000000,0,-14874000000,0,0,14736000000,14736000000,14736000000,0,0,29591000000,0,19000000,0,0,29610000000,94930000000,7765000000,6523000000,15171991000,15242855000,0,14288000000,FY2024.FQ4,4
92,0.25,2025-01-31,2024-12,250.42,15037874000,66025000000,3080000000,2.41,2.4,58275000000,0,-6254000000,0,0,36330000000,36330000000,36330000000,0,0,42832000000,0,-248000000,0,0,42584000000,124300000000,8268000000,7175000000,15081724000,15150865000,0,15443000000,FY2025.FQ1,1
93,0.25,2025-05-02,2025-03,222.13,14939315000,50492000000,2661000000,1.65,1.65,44867000000,0,-4530000000,0,0,24780000000,24780000000,24780000000,0,0,29589000000,0,-279000000,0,0,29310000000,95359000000,8550000000,6728000000,14994082000,15056133000,0,15278000000,FY2025.FQ2,2
