,dividends,original_filing_date,period_end_date,period_end_price,shares_eop,cogs,da_income_statement_supplemental,eps_basic,eps_diluted,gross_profit,income_allocated_to_minority_interest,income_tax,interest_expense,interest_income,net_income,net_income_available_to_shareholders,net_income_continuing,net_income_discontinued,net_interest_income_normal,operating_income,other_income_statement_items,other_nonoperating_income,other_opex,preferred_dividends,pretax_income,revenue,rnd,sga,shares_basic,shares_diluted,special_charges,total_opex,fiscal_year_key,fiscal_year_number
0,0.21,2001-12-10,2001-09,18.268,2018600000,21573000000,1754000000,-0.02,-0.02,3599000000,-104000000,-1059000000,0,0,-158000000,-158000000,224000000,0,0,2832000000,-278000000,-1549000000,767000000,0,1283000000,25172000000,0,0,2100000000,2100000000,0,767000000,FY2001,2001
1,0.21,2002-12-04,2002-09,14.853,2018600000,22924000000,1042000000,0.6,0.6,2405000000,-101000000,-853000000,0,0,1236000000,1236000000,1337000000,0,0,2384000000,0,-194000000,21000000,0,2190000000,25329000000,0,0,2044000000,2044000000,0,21000000,FY2002,2002
2,0.21,2003-12-12,2003-09,19.788,2013300000,24348000000,1077000000,0.59,0.59,2713000000,-127000000,-789000000,0,0,1267000000,1267000000,1465000000,0,0,2713000000,-71000000,-459000000,0,0,2254000000,27061000000,0,0,2147458000,2147458000,0,0,FY2003,2003
3,0.21,2004-12-13,2004-09,22.123,2054585000,26704000000,1210000000,1.08,1.07,4048000000,-197000000,-1197000000,0,0,2345000000,2345000000,2542000000,0,0,4048000000,0,-309000000,0,0,3739000000,30752000000,0,0,2171296000,2191589000,0,0,FY2004,2004
4,0.24,2005-12-07,2005-09,23.673,2007200000,27443000000,1341000000,1.21,1.19,3931000000,-177000000,-1174000000,0,0,2533000000,2533000000,2637000000,109000000,0,3931000000,-36000000,-120000000,0,0,3811000000,31374000000,0,0,2093388000,2128571000,0,0,FY2005,2005
5,0.27,2006-11-22,2006-09,30.325,2064000000,28392000000,1437000000,1.68,1.64,5355000000,-183000000,-1837000000,0,0,3374000000,3374000000,3487000000,70000000,0,5355000000,0,-31000000,0,0,5324000000,33747000000,0,0,2005000000,2076000000,0,0,FY2006,2006
6,0.31,2007-11-21,2007-09,34.39,1962200000,28729000000,1491000000,2.34,2.25,6781000000,-177000000,-2874000000,0,0,4687000000,4687000000,4851000000,13000000,0,6781000000,0,944000000,0,0,7725000000,35510000000,0,0,2004000000,2092000000,0,0,FY2007,2007
7,0.35,2008-11-20,2008-09,30.69,1822900000,30400000000,1582000000,2.34,2.28,7443000000,-302000000,-2673000000,-524000000,0,4427000000,4427000000,4729000000,0,-524000000,7443000000,0,483000000,0,0,7402000000,37843000000,0,0,1890000000,1948000000,0,0,FY2008,2008
8,0.35,2009-12-02,2009-09,27.46,1818300000,30452000000,1631000000,1.78,1.76,5697000000,-302000000,-2049000000,-588000000,122000000,3307000000,3307000000,3609000000,0,-466000000,5697000000,0,427000000,0,0,5658000000,36149000000,0,0,1856000000,1875000000,0,0,FY2009,2009
9,0.35,2010-11-24,2010-09,33.1,1896900000,31337000000,1713000000,2.07,2.03,6726000000,-350000000,-2314000000,-456000000,47000000,3963000000,3963000000,4313000000,0,-409000000,6726000000,0,310000000,0,0,6627000000,38063000000,0,0,1915000000,1948000000,0,0,FY2010,2010
10,0.4,2011-11-23,2011-09,30.16,1762200000,33112000000,1841000000,2.56,2.52,7781000000,-451000000,-2785000000,-435000000,92000000,4807000000,4807000000,5258000000,0,-343000000,7781000000,0,605000000,0,0,8043000000,40893000000,0,0,1878000000,1909000000,0,0,FY2011,2011
11,0.6,2012-11-21,2012-09,52.28,1800000000,23468000000,1987000000,3.17,3.13,18810000000,-491000000,-3087000000,-496000000,103000000,5682000000,5682000000,6173000000,0,-393000000,8863000000,0,790000000,1987000000,0,9260000000,42278000000,0,7960000000,1794000000,1818000000,0,9947000000,FY2012,2012
12,0.75,2013-11-20,2013-09,64.49,1800000000,25034000000,2192000000,3.42,3.38,20007000000,-500000000,-2984000000,-349000000,114000000,6136000000,6136000000,6636000000,0,-235000000,9450000000,0,405000000,2192000000,0,9620000000,45041000000,0,8365000000,1792000000,1813000000,0,10557000000,FY2013,2013
13,0.86,2014-11-19,2014-09,89.03,1700000000,26420000000,2288000000,4.31,4.26,22393000000,-503000000,-4242000000,-294000000,317000000,7501000000,7501000000,8004000000,0,23000000,11540000000,0,683000000,2288000000,0,12246000000,48813000000,0,8565000000,1740000000,1759000000,0,10853000000,FY2014,2014
14,1.81,2015-11-25,2015-09,102.2,1600000000,28364000000,2354000000,4.95,4.9,24101000000,-470000000,-5016000000,-265000000,148000000,8382000000,8382000000,8852000000,0,-117000000,13224000000,0,761000000,2354000000,0,13868000000,52465000000,0,8523000000,1694000000,1709000000,0,10877000000,FY2015,2015
15,1.42,2016-11-23,2016-09,92.86,1600000000,29993000000,2527000000,5.76,5.73,25639000000,-399000000,-5078000000,-354000000,94000000,9391000000,9391000000,9790000000,0,-260000000,14358000000,0,770000000,2527000000,0,14868000000,55632000000,0,8754000000,1629000000,1639000000,0,11281000000,FY2016,2016
16,1.56,2017-11-22,2017-09,98.57,1500000000,30306000000,2782000000,5.73,5.69,24831000000,-386000000,-4422000000,-507000000,122000000,8980000000,8980000000,9366000000,0,-385000000,13873000000,0,300000000,2782000000,0,13788000000,55137000000,0,8176000000,1568000000,1578000000,0,10958000000,FY2017,2017
17,1.68,2018-11-21,2018-09,116.94,1500000000,32726000000,3011000000,8.4,8.36,26708000000,-468000000,-1663000000,-682000000,108000000,12598000000,12598000000,13066000000,0,-574000000,14837000000,0,466000000,3011000000,0,14729000000,59434000000,0,8860000000,1499000000,1507000000,0,11871000000,FY2018,2018
18,1.76,2019-11-20,2019-09,130.32,1781000000,42061000000,4167000000,6.68,6.64,27546000000,-530000000,-3026000000,-1246000000,268000000,11054000000,11054000000,10897000000,687000000,-978000000,11830000000,0,3071000000,4167000000,0,13923000000,69607000000,0,11549000000,1656000000,1666000000,0,15716000000,FY2019,2019
19,0.88,2020-11-25,2020-09,124.08,1807063000,43880000000,5345000000,-1.58,-1.58,21508000000,-390000000,-699000000,-1647000000,156000000,-2864000000,-2864000000,-2442000000,-32000000,-1491000000,3794000000,0,-4046000000,5345000000,0,-1743000000,65388000000,0,12369000000,1808000000,1808000000,0,17714000000,FY2020,2020
20,0.0,2021-11-24,2021-09,169.17,1818000000,45131000000,5111000000,1.1,1.09,22287000000,-512000000,-25000000,-1546000000,140000000,1995000000,1995000000,2536000000,-29000000,-1406000000,3659000000,0,308000000,5111000000,0,2561000000,67418000000,0,13517000000,1816000000,1828000000,0,18628000000,FY2021,2021
21,0.0,2022-11-29,2022-09,94.33,1781000000,54401000000,5163000000,1.73,1.72,28321000000,-360000000,-1732000000,-1487000000,90000000,3145000000,3145000000,3553000000,-48000000,-1397000000,6770000000,0,-88000000,5163000000,0,5285000000,82722000000,0,16388000000,1822000000,1827000000,0,21551000000,FY2022,2022
22,0.0,2023-11-21,2023-09,81.05,1830000000,59201000000,5369000000,1.29,1.29,29697000000,-1036000000,-1379000000,-1633000000,424000000,2354000000,2354000000,3390000000,0,-1209000000,8992000000,0,-3014000000,5369000000,0,4769000000,88898000000,0,15336000000,1828000000,1830000000,0,20705000000,FY2023,2023
23,0.75,2024-11-14,2024-09,96.19,1808587000,58698000000,4990000000,2.72,2.72,32663000000,-801000000,-1796000000,-1666000000,406000000,4972000000,4972000000,5773000000,0,-1260000000,11914000000,0,-3085000000,4990000000,0,7569000000,91361000000,0,15759000000,1825000000,1831000000,0,20749000000,FY2024,2024
