,dividends,original_filing_date,period_end_date,period_end_price,shares_eop,cogs,da_income_statement_supplemental,eps_basic,eps_diluted,gross_profit,income_allocated_to_minority_interest,income_tax,interest_expense,interest_income,net_income,net_income_available_to_shareholders,net_income_continuing,net_income_discontinued,net_interest_income_normal,operating_income,other_income_statement_items,other_nonoperating_income,other_opex,preferred_dividends,pretax_income,revenue,rnd,sga,shares_basic,shares_diluted,special_charges,total_opex,fiscal_quarter_key,fiscal_quarter_number
0,0,2010-01-29,2008-12,0.0,1169607000,15864000,1294000,-0.02,-0.02,-1702000,0,-24000,-1099000,43000,-25498000,-25498000,-25498000,0,-1056000,-23224000,0,-1194000,0,0,-25474000,14162000,11826000,9696000,1169607000,1169607000,0,21522000,FY2008.FQ4,4
1,0,2010-06-29,2009-03,0.0,1169607000,22932000,1372000,-0.01,-0.01,-2046000,0,-8000,-1402000,16000,-16016000,-16016000,-16016000,0,-1386000,-16594000,0,1972000,0,0,-16008000,20886000,7941000,6607000,1169607000,1169607000,0,14548000,FY2009.FQ1,1
2,0,2010-08-13,2009-06,0.0,1169607000,24844000,1685000,0.0,0.0,2101000,0,-8000,-1086000,29000,-10867000,-10867000,-10867000,0,-1057000,-8087000,0,-1715000,0,0,-10859000,26945000,1941000,8247000,1169607000,1169607000,0,10188000,FY2009.FQ2,2
3,0,2010-01-29,2009-09,0.0,1169607000,37828000,1948000,0.0,0.0,7699000,0,219000,-18000,52000,-4615000,-4615000,-4615000,0,34000,-4291000,0,-577000,0,0,-4834000,45527000,1257000,10733000,1169607000,1169607000,0,11990000,FY2009.FQ3,3
4,0,2010-06-29,2009-12,0.0,1396641000,16804000,1935000,-0.02,-0.02,1781000,0,-229000,-25000,62000,-24242000,-24242000,-24242000,0,37000,-22925000,0,-1125000,0,0,-24013000,18585000,8143000,16563000,1169607000,1169607000,0,24706000,FY2009.FQ4,4
5,0,2010-06-29,2010-03,0.0,1396641000,16960000,2141000,-0.02,-0.02,3852000,0,-118000,-230000,48000,-29519000,-29519000,-29519000,0,-182000,-25998000,0,-3221000,0,0,-29401000,20812000,13265000,16585000,1396641000,1396641000,0,29850000,FY2010.FQ1,1
6,0,2010-08-13,2010-06,1.589,1396641000,22144000,2483000,-0.33,-0.33,6261000,0,-9000,-464000,47000,-38517000,-38517000,-38517000,0,-417000,-31362000,0,-6729000,0,0,-38508000,28405000,15416000,22207000,114652000,114652000,0,37623000,FY2010.FQ2,2
7,0,2010-11-12,2010-09,1.36,1398801000,21945000,3109000,-0.02,-0.02,9296000,0,-83000,-298000,100000,-34935000,-34935000,-34935000,0,-198000,-37834000,0,3180000,0,0,-34852000,31241000,26698000,20432000,1384061000,1384061000,0,47130000,FY2010.FQ3,3
8,0,2011-03-03,2010-12,1.775,1423626000,24965000,2890000,-0.03,-0.03,11321000,0,37000,0,63000,-51358000,-51358000,-51358000,0,63000,-51645000,0,187000,0,0,-51395000,36286000,37617000,25349000,1423626000,1423626000,0,62966000,FY2010.FQ4,4
9,0,2011-05-13,2011-03,1.85,1433323000,31002000,3517000,-0.03,-0.03,18028000,0,-150000,0,40000,-48941000,-48941000,-48941000,0,40000,-47346000,0,-1485000,0,0,-48791000,49030000,41162000,24212000,1427810000,1427810000,0,65374000,FY2011.FQ1,1
10,0,2011-08-12,2011-06,1.942,1559715000,39663000,4318000,-0.04,-0.04,18508000,0,-139000,0,46000,-58903000,-58903000,-58903000,0,46000,-58739000,0,-71000,0,0,-58764000,58171000,52531000,24716000,1466359000,1466359000,0,77247000,FY2011.FQ2,2
11,0,2011-11-14,2011-09,1.626,1562832000,40442000,4280000,-0.04,-0.04,17224000,0,-87000,0,80000,-65078000,-65078000,-65078000,0,80000,-64477000,0,-594000,0,0,-64991000,57666000,54083000,27618000,1561152000,1561152000,0,81701000,FY2011.FQ3,3
12,0,2012-02-27,2011-12,1.904,1567955000,31540000,4804000,-0.05,-0.05,7835000,0,-112000,-43000,89000,-81489000,-81489000,-81489000,0,46000,-80927000,0,-496000,0,0,-81377000,39375000,61205000,27557000,1566542000,1566542000,0,88762000,FY2011.FQ4,4
13,0,2012-05-10,2012-03,2.483,1577472000,19957000,4163000,-0.05,-0.05,10210000,0,-59000,-65000,90000,-89873000,-89873000,-89873000,0,25000,-88763000,0,-1076000,0,0,-89814000,30167000,68391000,30582000,1571765000,1571765000,0,98973000,FY2012.FQ1,1
14,0,2012-08-02,2012-06,2.086,1579850000,21891000,4348000,-0.06,-0.06,4762000,0,-109000,-84000,74000,-105603000,-105603000,-105603000,0,-10000,-106175000,0,691000,0,0,-105494000,26653000,74854000,36083000,1578637000,1578637000,0,110937000,FY2012.FQ2,2
15,0,2012-11-07,2012-09,1.952,1586586000,58865000,7522000,-0.07,-0.07,-8761000,0,-116000,-78000,38000,-110804000,-110804000,-110804000,0,-40000,-108460000,0,-2188000,0,0,-110688000,50104000,61901000,37798000,1583342000,1583342000,0,99699000,FY2012.FQ3,3
16,0,2013-03-07,2012-12,2.258,1713214000,282475000,12792000,-0.05,-0.05,23857000,0,148000,-26000,85000,-89931000,-89931000,-89931000,0,59000,-90883000,0,745000,0,0,-90079000,306332000,68832000,45908000,1707147000,1707147000,0,114740000,FY2012.FQ4,4
17,0,2013-05-10,2013-03,2.526,1727416000,465472000,17850000,0.0,0.0,96320000,0,-151000,-118000,10000,11248000,11248000,11248000,0,-108000,-5584000,0,17091000,0,0,11399000,561792000,54859000,47045000,1720678000,1863979000,0,101904000,FY2013.FQ1,1
18,0,2013-08-09,2013-06,7.157,1821445000,304656000,22198000,-0.01,-0.01,100483000,0,-301000,-20116000,39000,-30502000,-30502000,-30502000,0,-20077000,-11792000,0,1668000,0,0,-30201000,405139000,52312000,59963000,1772904000,1772904000,0,112275000,FY2013.FQ2,2
19,0,2013-11-08,2013-09,12.891,1838491000,328478000,28450000,-0.02,-0.02,102868000,0,-778000,-6492000,68000,-38496000,-38496000,-38496000,0,-6424000,-30554000,0,-740000,0,0,-37718000,431346000,56351000,77071000,1827937000,1827937000,0,133422000,FY2013.FQ3,3
20,0,2014-02-26,2013-12,10.029,1846365000,458630000,37585000,0.0,0.0,156589000,0,-1358000,-6229000,92000,-16264000,-16264000,-16264000,0,-6137000,-13353000,0,4584000,0,0,-14906000,615219000,68453000,101489000,1842561000,1842561000,0,169942000,FY2013.FQ4,4
21,0,2014-05-09,2014-03,13.897,1860611000,465414000,44268000,-0.02,-0.02,155128000,0,-809000,-11883000,141000,-49800000,-49800000,-49800000,0,-11742000,-43967000,0,6718000,0,0,-48991000,620542000,81544000,117551000,1852092000,1852092000,0,199095000,FY2014.FQ1,1
22,0,2014-08-08,2014-06,16.004,1868823000,556354000,54715000,-0.03,-0.03,212995000,0,-1150000,-31238000,467000,-61900000,-61900000,-61900000,0,-30771000,-28753000,0,-1226000,0,0,-60750000,769349000,107717000,134031000,1863756000,1863756000,0,241748000,FY2014.FQ2,2
23,0,2014-11-07,2014-09,16.179,1880493000,599953000,64972000,-0.04,-0.04,251851000,0,-3727000,-29062000,300000,-74708000,-74708000,-74708000,0,-28762000,-39129000,0,-3090000,0,0,-70981000,851804000,135873000,155107000,1873665000,1873665000,0,290980000,FY2014.FQ3,3
24,0,2015-02-26,2014-12,14.827,1885314000,694964000,67976000,-0.05,-0.05,261697000,0,-3719000,-28703000,219000,-107629000,-107629000,-107629000,0,-28484000,-74838000,0,-588000,0,0,-103910000,956661000,139565000,196970000,1882575000,1882575000,0,336535000,FY2014.FQ4,4
25,0,2015-05-11,2015-03,12.585,1895435000,679807000,77112000,-0.08,-0.08,260073000,0,-3040000,-26574000,184000,-154181000,-154181000,-154181000,0,-26390000,-102446000,0,-22305000,0,0,-151141000,939880000,167154000,195365000,1889205000,1889205000,0,362519000,FY2015.FQ1,1
26,0,2015-08-07,2015-06,17.884,1906514000,741606000,91389000,-0.09,-0.09,213370000,0,-3167000,-24352000,247000,-184227000,-184227000,-184227000,0,-24105000,-170188000,0,13233000,0,0,-181060000,954976000,181712000,201846000,1900335000,1900335000,0,383558000,FY2015.FQ2,2
27,0,2015-11-05,2015-09,16.56,1963515000,705293000,110366000,-0.11,-0.11,231496000,0,-1784000,-29308000,327000,-229858000,-229858000,-229858000,0,-28981000,-183662000,0,-15431000,0,0,-228074000,936789000,178791000,236367000,1935090000,1935090000,0,415158000,FY2015.FQ3,3
28,0,2016-02-24,2015-12,16.001,1971375000,995816000,143723000,-0.16,-0.16,218564000,0,-5048000,-38617000,750000,-320397000,-320397000,-320397000,0,-37867000,-260333000,0,-17149000,0,0,-315349000,1214380000,190243000,288654000,1966995000,1966995000,0,478897000,FY2015.FQ4,4
29,0,2016-05-10,2016-03,15.318,2007870000,894580000,156460000,-0.14,-0.14,252468000,0,-3846000,-40625000,1251000,-282267000,-282267000,-282267000,0,-39374000,-248224000,0,9177000,0,0,-278421000,1147048000,182482000,318210000,1990140000,1990140000,0,500692000,FY2016.FQ1,1
30,0,2016-08-05,2016-06,14.152,2220225000,995241000,183232000,-0.13,-0.13,274776000,0,-3649000,-46368000,2242000,-293188000,-293188000,-293188000,0,-44126000,-238040000,0,-7373000,0,0,-289539000,1270017000,191664000,321152000,2099745000,2099745000,0,512816000,FY2016.FQ2,2
31,0,2016-11-02,2016-09,13.602,2247375000,1661701000,280468000,0.01,0.0,636735000,0,-8133000,-46713000,2858000,21878000,21878000,21878000,0,-43855000,85622000,0,-11756000,0,0,30011000,2298436000,214302000,336811000,2234865000,2354025000,0,551113000,FY2016.FQ3,3
32,0,2017-03-01,2016-12,14.246,2423415000,1849353000,326939000,-0.05,-0.05,435278000,98132000,-11070000,-65104000,2179000,-121337000,-121337000,-219469000,0,-62925000,-266698000,0,121224000,0,0,-208399000,2284631000,245960000,456016000,2326575000,2326575000,0,701976000,FY2016.FQ4,4
33,0,2017-05-10,2017-03,18.553,2462460000,2028324000,376602000,-0.13,-0.13,667946000,66904000,-25278000,-99346000,3090000,-330277000,-330277000,-397181000,0,-96256000,-257549000,0,-18098000,0,0,-371903000,2696270000,322040000,603455000,2431935000,2431935000,0,925495000,FY2017.FQ1,1
34,0,2017-08-04,2017-06,24.107,2502945000,2122942000,389171000,-0.13,-0.13,666615000,65030000,-15647000,-108441000,4785000,-336397000,-336397000,-401427000,0,-103656000,-240916000,0,-41208000,0,0,-385780000,2789557000,369774000,537757000,2478180000,2478180000,0,907531000,FY2017.FQ2,2
35,0,2017-11-03,2017-09,22.74,2520255000,2535535000,400624000,-0.24,-0.24,449140000,51787000,285000,-117109000,5531000,-619376000,-619376000,-671163000,0,-111578000,-535480000,0,-24390000,0,0,-671448000,2984675000,331622000,652998000,2509410000,2509410000,0,984620000,FY2017.FQ3,3
36,0,2018-02-23,2017-12,20.757,2531955000,2849199000,469603000,-0.26,-0.26,439299000,95279000,8640000,-146104000,5594000,-675950000,-675950000,-771229000,0,-140510000,-598055000,0,-41304000,0,0,-779869000,3288498000,354564000,682790000,2539635000,2539635000,0,1037354000,FY2017.FQ4,4
37,0,2018-05-07,2018-03,17.742,2546250000,2952225000,416233000,-0.27,-0.27,456526000,75076000,-5605000,-149546000,5214000,-709551000,-709551000,-784627000,0,-144332000,-596974000,0,-37716000,0,0,-779022000,3408751000,367096000,686404000,2537190000,2537190000,0,1053500000,FY2018.FQ1,1
38,0,2018-08-06,2018-06,22.863,2557740000,3383301000,485255000,-0.28,-0.28,618930000,25167000,-13707000,-163582000,5064000,-717539000,-717539000,-742706000,0,-158518000,-517958000,0,-52523000,0,0,-728999000,4002231000,386129000,750759000,2549955000,2549955000,0,1136888000,FY2018.FQ2,2
39,0,2018-11-02,2018-09,17.651,2573670000,5300000000,502512000,0.12,0.11,1524000000,57000000,-17000000,-175000000,7000000,311000000,311000000,254000000,0,-168000000,443000000,0,-4000000,0,0,271000000,6824000000,351000000,730000000,2565000000,2670000000,0,1081000000,FY2018.FQ3,3
40,0,2019-02-19,2018-12,22.187,2589039000,5783000000,497000000,0.05,0.05,1443000000,-70000000,-22000000,-175000000,7000000,140000000,140000000,210000000,0,-168000000,419000000,0,-19000000,0,0,232000000,7226000000,356000000,668000000,2586000000,2586000000,0,1024000000,FY2018.FQ4,4
41,0,2019-04-29,2019-03,18.657,2605230000,3975000000,468000000,-0.27,-0.27,566000000,-34000000,-23000000,-158000000,9000000,-702000000,-702000000,-668000000,0,-149000000,-478000000,0,-18000000,0,0,-645000000,4541000000,340000000,704000000,2595000000,2595000000,0,1044000000,FY2019.FQ1,1
42,0,2019-07-29,2019-06,14.897,2686770000,5429000000,579000000,-0.15,-0.15,921000000,-19000000,-19000000,-172000000,10000000,-408000000,-408000000,-389000000,0,-162000000,-50000000,0,-158000000,0,0,-370000000,6350000000,324000000,647000000,2655000000,2655000000,0,971000000,FY2019.FQ2,2
43,0,2019-10-29,2019-09,16.058,2700000000,5112000000,530000000,0.05,0.05,1191000000,-7000000,-26000000,-185000000,15000000,143000000,143000000,150000000,0,-170000000,261000000,0,85000000,0,0,176000000,6303000000,334000000,596000000,2691000000,2766000000,0,930000000,FY2019.FQ3,3
44,0,2020-02-13,2019-12,27.889,2715931000,5993000000,577000000,0.03,0.03,1391000000,-27000000,-42000000,-170000000,10000000,105000000,105000000,132000000,0,-160000000,347000000,0,-13000000,0,0,174000000,7384000000,345000000,699000000,2706000000,2706000000,0,1044000000,FY2019.FQ4,4
45,0,2020-04-30,2020-03,34.933,2775000000,4751000000,553000000,0.0,0.0,1234000000,-52000000,-2000000,-169000000,10000000,16000000,16000000,68000000,0,-159000000,283000000,0,-54000000,0,0,70000000,5985000000,324000000,627000000,2745000000,2982000000,0,951000000,FY2020.FQ1,1
46,0,2020-07-28,2020-06,71.987,2794789000,4769000000,567000000,0.03,0.03,1267000000,-25000000,-21000000,-170000000,8000000,104000000,104000000,129000000,0,-162000000,327000000,0,-15000000,0,0,150000000,6036000000,279000000,661000000,2784000000,3108000000,0,940000000,FY2020.FQ2,2
47,0,2020-10-26,2020-09,143.003,2843561000,6708000000,584000000,0.1,0.09,2063000000,-69000000,-186000000,-163000000,6000000,300000000,300000000,369000000,0,-157000000,809000000,0,-97000000,0,0,555000000,8771000000,366000000,888000000,2811000000,3315000000,0,1254000000,FY2020.FQ3,3
48,0,2021-02-08,2020-12,235.223,2880000000,8678000000,618000000,0.09,0.08,2066000000,5000000,-83000000,-246000000,6000000,301000000,301000000,296000000,0,-240000000,575000000,0,44000000,0,0,379000000,10744000000,522000000,969000000,2853000000,3465000000,0,1491000000,FY2020.FQ4,4
49,0,2021-04-28,2021-03,222.643,2889000000,8174000000,621000000,0.15,0.13,2215000000,-26000000,-69000000,-99000000,10000000,438000000,438000000,464000000,0,-89000000,493000000,0,129000000,0,0,533000000,10389000000,666000000,1056000000,2883000000,3399000000,0,1722000000,FY2021.FQ1,1
50,0,2021-07-27,2021-06,226.567,2952000000,9074000000,681000000,0.39,0.34,2884000000,-36000000,-115000000,-75000000,11000000,1142000000,1142000000,1178000000,0,-64000000,1335000000,0,22000000,0,0,1293000000,11958000000,576000000,973000000,2913000000,3357000000,0,1549000000,FY2021.FQ2,2
51,0,2021-10-25,2021-09,258.493,3012000000,10097000000,761000000,0.54,0.48,3660000000,-41000000,-223000000,-126000000,10000000,1618000000,1618000000,1659000000,0,-116000000,2055000000,0,-57000000,0,0,1882000000,13757000000,611000000,994000000,2993000000,3369000000,0,1605000000,FY2021.FQ3,3
52,0,2022-02-07,2021-12,352.26,3099000000,12872000000,848000000,0.76,0.68,4847000000,-17000000,-292000000,-71000000,25000000,2326000000,2326000000,2343000000,0,-46000000,2613000000,0,68000000,0,0,2635000000,17719000000,740000000,1494000000,3043000000,3371000000,0,2234000000,FY2021.FQ4,4
53,0,2022-04-25,2022-03,359.2,3108000000,13296000000,880000000,1.07,0.95,5460000000,38000000,-346000000,-61000000,28000000,3318000000,3318000000,3280000000,0,-33000000,3603000000,0,56000000,0,0,3626000000,18756000000,865000000,992000000,3103000000,3472000000,0,1857000000,FY2022.FQ1,1
54,0,2022-07-25,2022-06,224.473,3123000000,12700000000,922000000,0.73,0.65,4234000000,-10000000,-205000000,-44000000,26000000,2259000000,2259000000,2269000000,0,-18000000,2606000000,0,-114000000,0,0,2474000000,16934000000,667000000,961000000,3111000000,3464000000,0,1628000000,FY2022.FQ2,2
55,0,2022-10-24,2022-09,265.25,3158000000,16072000000,956000000,1.05,0.95,5382000000,-39000000,-305000000,-53000000,86000000,3292000000,3292000000,3331000000,0,33000000,3688000000,0,-85000000,0,0,3636000000,21454000000,733000000,961000000,3146000000,3468000000,0,1694000000,FY2022.FQ3,3
56,0,2023-01-31,2022-12,123.18,3164000000,18541000000,989000000,1.18,1.07,5777000000,7000000,-276000000,-33000000,157000000,3714000000,3714000000,3707000000,0,124000000,3935000000,0,-76000000,0,0,3983000000,24318000000,810000000,1032000000,3160000000,3478000000,0,1842000000,FY2022.FQ4,4
57,0,2023-04-24,2023-03,207.46,3169000000,18818000000,1046000000,0.8,0.73,4511000000,-26000000,-261000000,-29000000,213000000,2513000000,2513000000,2539000000,0,184000000,2664000000,0,-48000000,0,0,2800000000,23329000000,771000000,1076000000,3166000000,3468000000,0,1847000000,FY2023.FQ1,1
58,0,2023-07-24,2023-06,261.77,3174000000,20394000000,1154000000,0.85,0.78,4533000000,89000000,-323000000,-28000000,238000000,2703000000,2703000000,2614000000,0,210000000,2399000000,0,328000000,0,0,2937000000,24927000000,943000000,1191000000,3171000000,3478000000,0,2134000000,FY2023.FQ2,2
59,0,2023-10-23,2023-09,250.22,3179000000,19172000000,1235000000,0.58,0.53,4178000000,-25000000,-167000000,-38000000,282000000,1853000000,1853000000,1878000000,0,244000000,1764000000,0,37000000,0,0,2045000000,23350000000,1161000000,1253000000,3176000000,3493000000,0,2414000000,FY2023.FQ3,3
60,0,2024-01-29,2023-12,248.48,3185000000,20729000000,1232000000,2.49,2.27,4438000000,-13000000,5752000000,-61000000,333000000,7930000000,7930000000,7943000000,0,272000000,2064000000,0,-145000000,0,0,2191000000,25167000000,1094000000,1280000000,3183000000,3497000000,0,2374000000,FY2023.FQ4,4
61,0,2024-04-24,2024-03,175.79,3188966000,17605000000,1246000000,0.45,0.41,3696000000,-15000000,-483000000,-76000000,350000000,1390000000,1390000000,1405000000,0,274000000,1171000000,0,443000000,0,0,1888000000,21301000000,1151000000,1374000000,3186000000,3484000000,0,2525000000,FY2024.FQ1,1
62,0,2024-07-24,2024-06,197.88,3194640000,20922000000,1278000000,0.46,0.42,4578000000,-16000000,-393000000,-86000000,348000000,1478000000,1478000000,1494000000,0,262000000,2227000000,0,-602000000,0,0,1887000000,25500000000,1074000000,1277000000,3191000000,3481000000,0,2351000000,FY2024.FQ2,2
63,0,2024-10-24,2024-09,261.63,3207000000,20185000000,1348000000,0.68,0.62,4997000000,-16000000,-601000000,-92000000,429000000,2167000000,2167000000,2183000000,0,337000000,2772000000,0,-325000000,0,0,2784000000,25182000000,1039000000,1186000000,3198000000,3497000000,0,2225000000,FY2024.FQ3,3
64,0,2025-01-30,2024-12,403.84,3216000000,21528000000,1496000000,0.72,0.66,4179000000,24000000,-434000000,-96000000,442000000,2356000000,2356000000,2332000000,0,346000000,1590000000,0,830000000,0,0,2766000000,25707000000,1276000000,1313000000,3212000000,3525000000,0,2589000000,FY2024.FQ4,4
65,0,2025-04-23,2025-03,259.16,3220000000,16182000000,1447000000,0.13,0.12,3153000000,-11000000,-169000000,-91000000,400000000,409000000,409000000,420000000,0,309000000,493000000,0,-213000000,0,0,589000000,19335000000,1409000000,1251000000,3218000000,3521000000,0,2660000000,FY2025.FQ1,1
