,dividends,original_filing_date,period_end_date,period_end_price,shares_eop,cogs,da_income_statement_supplemental,eps_basic,eps_diluted,gross_profit,income_allocated_to_minority_interest,income_tax,interest_expense,interest_income,net_income,net_income_available_to_shareholders,net_income_continuing,net_income_discontinued,net_interest_income_normal,operating_income,other_income_statement_items,other_nonoperating_income,other_opex,preferred_dividends,pretax_income,revenue,rnd,sga,shares_basic,shares_diluted,special_charges,total_opex,fiscal_quarter_key,fiscal_quarter_number
0,0.0,2012-05-18,2011-03,0.0,2556000000,167000000,51000000,0.06,0.06,564000000,0,-165000000,-7000000,0,233000000,233000000,233000000,0,-7000000,388000000,0,17000000,0,0,398000000,731000000,57000000,119000000,2456000000,2556000000,0,176000000,FY2011.FQ1,1
1,0.0,2012-07-31,2011-06,0.0,2556000000,210000000,72000000,0.06,0.06,685000000,0,-159000000,-9000000,0,240000000,240000000,240000000,0,-9000000,407000000,0,1000000,0,0,399000000,895000000,99000000,179000000,2456000000,2556000000,0,278000000,FY2011.FQ2,2
2,0.0,2012-10-24,2011-09,0.0,2556000000,236000000,97000000,0.06,0.05,718000000,0,-152000000,-10000000,0,227000000,227000000,227000000,0,-10000000,414000000,0,-25000000,0,0,379000000,954000000,108000000,196000000,2456000000,2556000000,0,304000000,FY2011.FQ3,3
3,0.0,2012-05-18,2011-12,0.0,2138085000,247000000,103000000,0.15,0.14,884000000,0,-217000000,-12000000,0,302000000,302000000,302000000,0,-12000000,547000000,0,-16000000,0,0,519000000,1131000000,124000000,213000000,2456000000,2556000000,0,337000000,FY2011.FQ4,4
4,0.0,2012-05-18,2012-03,0.0,2138085000,277000000,110000000,0.06,0.06,781000000,0,-177000000,-13000000,0,205000000,205000000,205000000,0,-13000000,381000000,0,14000000,0,0,382000000,1058000000,153000000,247000000,2138085000,2138085000,0,400000000,FY2012.FQ1,1
5,0.0,2012-07-31,2012-06,31.1,2142000000,367000000,139000000,-0.08,-0.08,817000000,0,608000000,-10000000,0,-157000000,-157000000,-157000000,0,-10000000,-743000000,0,-12000000,0,0,-765000000,1184000000,705000000,855000000,1879000000,1879000000,0,1560000000,FY2012.FQ2,2
6,0.0,2012-10-24,2012-09,21.66,2166000000,322000000,176000000,-0.02,-0.02,940000000,0,-431000000,-11000000,0,-59000000,-59000000,-59000000,0,-11000000,377000000,0,6000000,0,0,372000000,1262000000,244000000,319000000,2420000000,2420000000,0,563000000,FY2012.FQ3,3
7,0.0,2013-02-01,2012-12,26.62,2372000000,397000000,224000000,0.03,0.03,1188000000,0,-441000000,0,0,64000000,64000000,64000000,0,0,523000000,0,-2000000,0,0,505000000,1585000000,297000000,368000000,2372000000,3012000000,0,665000000,FY2012.FQ4,4
8,0.0,2013-05-02,2013-03,25.58,2411000000,413000000,233000000,0.09,0.09,1045000000,0,-134000000,-20000000,0,219000000,219000000,219000000,0,-20000000,373000000,0,0,0,0,353000000,1458000000,293000000,379000000,2386000000,2499000000,0,672000000,FY2013.FQ1,1
9,0.0,2013-07-25,2013-06,24.88,2431000000,465000000,230000000,0.14,0.13,1348000000,0,-212000000,-17000000,0,333000000,333000000,333000000,0,-17000000,562000000,0,0,0,0,545000000,1813000000,344000000,442000000,2407000000,2502000000,0,786000000,FY2013.FQ2,2
10,0.0,2013-11-01,2013-09,50.23,2453000000,507000000,274000000,0.17,0.17,1509000000,0,-301000000,-10000000,0,425000000,425000000,425000000,0,-10000000,736000000,0,0,0,0,726000000,2016000000,369000000,404000000,2430000000,2528000000,0,773000000,FY2013.FQ3,3
11,0.0,2014-01-31,2013-12,54.65,2547000000,491000000,274000000,0.21,0.2,2095000000,0,-607000000,12000000,0,523000000,523000000,523000000,0,12000000,1132000000,0,-14000000,0,0,1130000000,2586000000,409000000,554000000,2456000000,2556000000,0,963000000,FY2013.FQ4,4
12,0.0,2014-04-25,2014-03,60.24,2564000000,462000000,264000000,0.25,0.25,2040000000,0,-433000000,0,0,642000000,642000000,642000000,0,0,1075000000,0,0,0,0,1075000000,2502000000,455000000,510000000,2545000000,2609000000,0,965000000,FY2014.FQ1,1
13,0.0,2014-07-24,2014-06,67.29,2575000000,473000000,257000000,0.31,0.3,2437000000,0,-595000000,-4000000,0,791000000,791000000,791000000,0,-4000000,1390000000,0,0,0,0,1386000000,2910000000,492000000,555000000,2560000000,2615000000,0,1047000000,FY2014.FQ2,2
14,0.0,2014-10-30,2014-09,79.04,2608000000,565000000,289000000,0.31,0.3,2638000000,0,-530000000,-65000000,4000000,806000000,806000000,806000000,0,-61000000,1397000000,0,0,0,0,1336000000,3203000000,608000000,633000000,2587000000,2644000000,0,1241000000,FY2014.FQ3,3
15,0.0,2015-01-29,2014-12,78.02,2778000000,652000000,433000000,0.25,0.25,3199000000,0,-413000000,45000000,23000000,701000000,701000000,701000000,0,68000000,1133000000,0,-87000000,0,0,1114000000,3851000000,1111000000,955000000,2761000000,2808000000,0,2066000000,FY2014.FQ4,4
16,0.0,2015-04-23,2015-03,82.22,2806000000,654000000,457000000,0.18,0.18,2889000000,0,-420000000,-3000000,2000000,512000000,512000000,512000000,0,-1000000,933000000,0,0,0,0,932000000,3543000000,1062000000,894000000,2784000000,2836000000,0,1956000000,FY2015.FQ1,1
17,0.0,2015-07-31,2015-06,85.77,2800000000,668000000,459000000,0.26,0.25,3374000000,0,-554000000,-5000000,5000000,719000000,719000000,719000000,0,0,1273000000,0,0,0,0,1273000000,4042000000,1170000000,931000000,2796000000,2850000000,0,2101000000,FY2015.FQ2,2
18,0.0,2015-11-05,2015-09,89.9,2814000000,720000000,486000000,0.32,0.31,3781000000,0,-536000000,-34000000,7000000,896000000,896000000,896000000,0,-27000000,1459000000,0,0,0,0,1432000000,4501000000,1271000000,1051000000,2808000000,2863000000,0,2322000000,FY2015.FQ3,3
19,0.0,2016-01-28,2015-12,104.66,2834000000,824000000,543000000,0.55,0.54,5017000000,0,-996000000,26000000,37000000,1561000000,1561000000,1561000000,0,63000000,2560000000,0,-66000000,0,0,2557000000,5841000000,1314000000,1143000000,2824000000,2868000000,0,2457000000,FY2015.FQ4,4
20,0.0,2016-04-28,2016-03,114.1,2850000000,838000000,552000000,0.61,0.6,4544000000,0,-328000000,29000000,27000000,1738000000,1738000000,1738000000,0,56000000,2010000000,0,0,0,0,2066000000,5382000000,1343000000,1191000000,2843000000,2905000000,0,2534000000,FY2016.FQ1,1
21,0.0,2016-07-28,2016-06,114.28,2862000000,917000000,585000000,0.8,0.78,5519000000,0,-471000000,-12000000,32000000,2283000000,2283000000,2283000000,0,20000000,2734000000,0,0,0,0,2754000000,6436000000,1471000000,1314000000,2856000000,2921000000,0,2785000000,FY2016.FQ2,2
22,0.0,2016-11-03,2016-09,128.27,2877000000,987000000,591000000,0.91,0.9,6024000000,0,-537000000,-3000000,50000000,2627000000,2627000000,2627000000,0,47000000,3117000000,0,0,0,0,3164000000,7011000000,1542000000,1365000000,2871000000,2931000000,0,2907000000,FY2016.FQ3,3
23,0.0,2017-02-03,2016-12,115.05,2892000000,1047000000,614000000,1.24,1.21,7762000000,0,-964000000,-24000000,66000000,3569000000,3569000000,3569000000,0,42000000,4567000000,0,-76000000,0,0,4533000000,8809000000,1563000000,1632000000,2881000000,2946000000,0,3195000000,FY2016.FQ4,4
24,0.0,2017-05-04,2017-03,142.05,2893000000,1159000000,671000000,1.06,1.04,6873000000,0,-344000000,14000000,67000000,3064000000,3064000000,3064000000,0,81000000,3327000000,0,0,0,0,3408000000,8032000000,1834000000,1712000000,2891000000,2944000000,0,3546000000,FY2017.FQ1,1
25,0.0,2017-07-27,2017-06,150.98,2900000000,1237000000,729000000,1.34,1.32,8084000000,0,-594000000,-4000000,91000000,3894000000,3894000000,3894000000,0,87000000,4401000000,0,0,0,0,4488000000,9321000000,1919000000,1764000000,2900000000,2951000000,0,3683000000,FY2017.FQ2,2
26,0.0,2017-11-02,2017-09,168.73,2906000000,1448000000,772000000,1.62,1.59,8880000000,0,-529000000,6000000,108000000,4707000000,4707000000,4707000000,0,114000000,5122000000,0,0,0,0,5236000000,10328000000,2052000000,1706000000,2904000000,2956000000,0,3758000000,FY2017.FQ3,3
27,0.0,2018-02-01,2017-12,176.46,2906000000,1611000000,853000000,1.47,1.44,11361000000,0,-3193000000,-16000000,132000000,4269000000,4269000000,4269000000,0,116000000,7352000000,0,-6000000,0,0,7462000000,12972000000,1949000000,2060000000,2910000000,2962000000,0,4009000000,FY2017.FQ4,4
28,0.0,2018-04-26,2018-03,159.79,2902000000,1927000000,949000000,1.72,1.69,10039000000,0,-622000000,16000000,145000000,4988000000,4988000000,4988000000,0,161000000,5449000000,0,0,0,0,5610000000,11966000000,2238000000,2352000000,2906000000,2945000000,0,4590000000,FY2018.FQ1,1
29,0.0,2018-07-26,2018-06,194.32,2891000000,2214000000,1034000000,1.76,1.74,11017000000,0,-762000000,-138000000,143000000,5106000000,5106000000,5106000000,0,5000000,5863000000,0,0,0,0,5868000000,13231000000,2523000000,2631000000,2895000000,2930000000,0,5154000000,FY2018.FQ2,2
30,0.0,2018-10-31,2018-09,164.46,2873000000,2418000000,1107000000,1.78,1.76,11309000000,0,-775000000,-45000000,176000000,5137000000,5137000000,5137000000,0,131000000,5781000000,0,0,0,0,5912000000,13727000000,2657000000,2871000000,2885000000,2913000000,0,5528000000,FY2018.FQ3,3
31,0.0,2019-01-31,2018-12,131.09,2854000000,2796000000,1225000000,2.4,2.38,14118000000,0,-1089000000,177000000,187000000,6882000000,6882000000,6882000000,0,364000000,7820000000,0,-213000000,0,0,7971000000,16914000000,2855000000,3443000000,2875000000,2891000000,0,6298000000,FY2018.FQ4,4
32,0.0,2019-04-25,2019-03,166.69,2856000000,2816000000,1355000000,0.85,0.85,12261000000,0,-1053000000,-33000000,198000000,2429000000,2429000000,2429000000,0,165000000,6317000000,0,-3000000000,0,0,3482000000,15077000000,2860000000,3084000000,2856000000,2869000000,0,5944000000,FY2019.FQ1,1
33,0.0,2019-07-25,2019-06,193.0,2854000000,3307000000,1502000000,0.92,0.91,13579000000,0,-2216000000,-13000000,219000000,2616000000,2616000000,2616000000,0,206000000,6626000000,0,-2000000000,0,0,4832000000,16886000000,3315000000,3638000000,2855000000,2875000000,0,6953000000,FY2019.FQ2,2
34,0.0,2019-10-31,2019-09,178.08,2854000000,3155000000,1416000000,2.13,2.12,14497000000,0,-1238000000,-114000000,258000000,6091000000,6091000000,6091000000,0,144000000,7185000000,0,0,0,0,7329000000,17652000000,3548000000,3764000000,2854000000,2874000000,0,7312000000,FY2019.FQ3,3
35,0.0,2020-01-30,2019-12,205.25,2852000000,3491000000,1468000000,2.58,2.56,17591000000,0,-1820000000,187000000,229000000,7349000000,7349000000,7349000000,0,416000000,8858000000,0,-105000000,0,0,9169000000,21082000000,3878000000,4855000000,2851000000,2879000000,0,8733000000,FY2019.FQ4,4
36,0.0,2020-04-30,2020-03,166.8,2851000000,3459000000,1597000000,1.72,1.71,14278000000,0,-959000000,-9000000,228000000,4902000000,4902000000,4902000000,0,219000000,5893000000,0,-251000000,0,0,5861000000,17737000000,4015000000,4370000000,2851000000,2868000000,0,8385000000,FY2020.FQ1,1
37,0.0,2020-07-31,2020-06,227.07,2850000000,3829000000,1704000000,1.82,1.8,14858000000,0,-953000000,-22000000,162000000,5178000000,5178000000,5178000000,0,140000000,5963000000,0,28000000,0,0,6131000000,18687000000,4462000000,4433000000,2850000000,2879000000,0,8895000000,FY2020.FQ2,2
38,0.0,2020-10-30,2020-09,261.9,2850000000,4194000000,1698000000,2.75,2.71,17276000000,0,-287000000,-15000000,146000000,7846000000,7846000000,7846000000,0,131000000,8040000000,0,-38000000,0,0,8133000000,21470000000,4763000000,4473000000,2850000000,2891000000,0,9236000000,FY2020.FQ3,3
39,0.0,2021-01-28,2020-12,273.16,2849000000,5210000000,1863000000,3.94,3.88,22862000000,0,-1836000000,12000000,136000000,11219000000,11219000000,11219000000,0,148000000,12775000000,0,132000000,0,0,13055000000,28072000000,5207000000,4880000000,2854000000,2903000000,0,10087000000,FY2020.FQ4,4
40,0.0,2021-04-29,2021-03,294.53,2841000000,5131000000,1972000000,3.34,3.3,21040000000,0,-2006000000,100000000,118000000,9497000000,9497000000,9497000000,0,218000000,11378000000,0,-93000000,0,0,11503000000,26171000000,5197000000,4465000000,2847000000,2882000000,0,9662000000,FY2021.FQ1,1
41,0.0,2021-07-29,2021-06,347.71,2826000000,5399000000,1986000000,3.67,3.61,23678000000,0,-2119000000,25000000,121000000,10394000000,10394000000,10394000000,0,146000000,12367000000,0,0,0,0,12513000000,29077000000,6096000000,5215000000,2834000000,2877000000,0,11311000000,FY2021.FQ2,2
42,0.0,2021-10-26,2021-09,339.39,2793000000,5771000000,1995000000,3.27,3.22,23239000000,0,-1371000000,70000000,120000000,9194000000,9194000000,9194000000,0,190000000,10423000000,0,-48000000,0,0,10565000000,29010000000,6316000000,6500000000,2814000000,2859000000,0,12816000000,FY2021.FQ3,3
43,0.0,2022-02-03,2021-12,336.35,2741000000,6348000000,2014000000,3.72,3.67,27323000000,0,-2418000000,-8000000,125000000,10285000000,10285000000,10285000000,0,117000000,12585000000,0,1000000,0,0,12703000000,33671000000,7046000000,7692000000,2764000000,2808000000,0,14738000000,FY2021.FQ4,4
44,0.0,2022-04-28,2022-03,222.36,2714000000,6005000000,2156000000,2.74,2.72,21903000000,0,-1443000000,249000000,81000000,7465000000,7465000000,7465000000,0,330000000,8524000000,0,54000000,0,0,8908000000,27908000000,7707000000,5672000000,2725000000,2742000000,0,13379000000,FY2022.FQ1,1
45,0.0,2022-07-28,2022-06,161.25,2697000000,5192000000,1979000000,2.47,2.46,23630000000,0,-1499000000,-208000000,96000000,6687000000,6687000000,6687000000,0,-112000000,8358000000,0,-60000000,0,0,8186000000,28822000000,8690000000,6582000000,2704000000,2713000000,0,15272000000,FY2022.FQ2,2
46,0.0,2022-10-27,2022-09,135.68,2665000000,5716000000,2175000000,1.64,1.64,21998000000,0,-1181000000,-99000000,142000000,4395000000,4395000000,4395000000,0,43000000,5664000000,0,-131000000,0,0,5576000000,27714000000,9170000000,7164000000,2682000000,2687000000,0,16334000000,FY2022.FQ3,3
47,0.0,2023-02-02,2022-12,120.34,2614000000,8336000000,2376000000,1.76,1.76,23829000000,0,-1496000000,-449000000,142000000,4653000000,4653000000,4653000000,0,-307000000,6399000000,0,57000000,0,0,6149000000,32165000000,9771000000,7659000000,2639000000,2654000000,0,17430000000,FY2022.FQ4,4
48,0.0,2023-04-27,2023-03,211.94,2566000000,6108000000,2524000000,2.21,2.2,22537000000,0,-1598000000,-50000000,193000000,5709000000,5709000000,5709000000,0,143000000,7227000000,0,-63000000,0,0,7307000000,28645000000,9381000000,5929000000,2587000000,2596000000,0,15310000000,FY2023.FQ1,1
49,0.0,2023-07-27,2023-06,286.98,2573000000,5945000000,2623000000,3.03,2.98,26054000000,0,-1505000000,-277000000,323000000,7788000000,7788000000,7788000000,0,46000000,9392000000,0,-145000000,0,0,9293000000,31999000000,9344000000,7318000000,2568000000,2612000000,0,16662000000,FY2023.FQ2,2
50,0.0,2023-10-26,2023-09,300.21,2571000000,6210000000,2859000000,4.5,4.39,27936000000,0,-2437000000,-164000000,534000000,11583000000,11583000000,11583000000,0,370000000,13748000000,0,-98000000,0,0,14020000000,34146000000,9241000000,4947000000,2576000000,2641000000,0,14188000000,FY2023.FQ3,3
51,0.0,2024-02-02,2023-12,353.96,2561000000,7695000000,3172000000,5.46,5.33,32416000000,0,-2790000000,-104000000,588000000,14017000000,14017000000,14017000000,0,484000000,16384000000,0,-61000000,0,0,16807000000,40111000000,10517000000,5515000000,2565000000,2647000000,0,16032000000,FY2023.FQ4,4
52,0.5,2024-04-25,2024-03,485.58,2537000000,6640000000,3374000000,4.86,4.71,29815000000,0,-1814000000,-72000000,585000000,12369000000,12369000000,12369000000,0,513000000,13818000000,0,-148000000,0,0,14183000000,36455000000,9978000000,6019000000,2545000000,2625000000,0,15997000000,FY2024.FQ1,1
53,0.5,2024-08-01,2024-06,504.22,2533088000,7308000000,3637000000,5.31,5.16,31763000000,0,-1641000000,-113000000,540000000,13465000000,13465000000,13465000000,0,427000000,14847000000,0,-168000000,0,0,15106000000,39071000000,10537000000,6379000000,2534000000,2610000000,0,16916000000,FY2024.FQ2,2
54,0.5,2024-10-31,2024-09,572.44,2524000000,7375000000,4027000000,6.2,6.03,33214000000,0,-2134000000,-200000000,661000000,15688000000,15688000000,15688000000,0,461000000,17350000000,0,11000000,0,0,17822000000,40589000000,11177000000,4687000000,2529000000,2600000000,0,15864000000,FY2024.FQ3,3
55,0.5,2025-01-30,2024-12,585.51,2534488000,8839000000,4460000000,8.24,8.02,39546000000,0,-2714000000,-158000000,731000000,20838000000,20838000000,20838000000,0,573000000,23364000000,0,-385000000,0,0,23552000000,48385000000,12180000000,4002000000,2528000000,2611000000,0,16182000000,FY2024.FQ4,4
56,0.525,2025-05-01,2025-03,576.36,2524450000,7572000000,3900000000,6.59,6.43,34742000000,0,-1738000000,-63000000,658000000,16644000000,16644000000,16644000000,0,595000000,17555000000,0,232000000,0,0,18382000000,42314000000,12150000000,5037000000,2527000000,2590000000,0,17187000000,FY2025.FQ1,1
