,dividends,original_filing_date,period_end_date,period_end_price,shares_eop,cogs,da_income_statement_supplemental,eps_basic,eps_diluted,gross_profit,income_allocated_to_minority_interest,income_tax,interest_expense,interest_income,net_income,net_income_available_to_shareholders,net_income_continuing,net_income_discontinued,net_interest_income_normal,operating_income,other_income_statement_items,other_nonoperating_income,other_opex,preferred_dividends,pretax_income,revenue,rnd,sga,shares_basic,shares_diluted,special_charges,total_opex,fiscal_quarter_key,fiscal_quarter_number
0,0,2002-04-24,2002-03,0.715,7502180000,624297000,22919000,0.0,0.0,223125000,0,0,-35244000,5652000,-23951000,-23951000,-22207000,0,-29592000,11748000,-1744000,-4363000,147291000,0,-22207000,847422000,0,64086000,7460620000,7460620000,0,211377000,FY2002.FQ1,1
1,0,2002-07-26,2002-06,0.813,7606080000,587438000,22344000,-0.01,-0.01,218167000,0,0,-35651000,5650000,-93553000,-93553000,-92385000,0,-30001000,1472000,-1168000,-63856000,145290000,0,-92385000,805605000,0,71405000,7538740000,7538740000,0,216695000,FY2002.FQ2,2
2,0,2002-10-25,2002-09,0.799,7624320000,635132000,21713000,0.0,0.0,216167000,0,0,-35922000,5600000,-35080000,-35080000,-34523000,0,-30322000,27112000,-557000,-31313000,144461000,0,-34523000,851299000,0,44594000,7593000000,7593000000,0,189055000,FY2002.FQ3,3
3,0,2003-02-19,2002-12,0.945,7758120000,1093451000,15298000,0.0,0.0,335159000,0,0,-36108000,6785000,2651000,2651000,-1518000,0,-29323000,23792000,4169000,4013000,218093000,0,-1518000,1428610000,0,93274000,7675200000,7675200000,0,311367000,FY2002.FQ4,4
4,0,2003-04-25,2003-03,1.302,7832180000,812977000,19750000,0.0,0.0,270582000,0,0,-36511000,6540000,-10121000,-10121000,-10121000,0,-29971000,39225000,0,-19375000,154705000,0,-10121000,1083559000,0,76652000,7770820000,7770820000,0,231357000,FY2003.FQ1,1
5,0,2003-07-24,2003-06,1.816,7934600000,825984000,19003000,0.0,0.0,273928000,0,0,-34367000,5761000,-43314000,-43314000,-43314000,0,-28606000,41823000,0,-56531000,160503000,0,-43314000,1099912000,0,71602000,7877520000,7877520000,0,232105000,FY2003.FQ2,2
6,0,2003-10-24,2003-09,2.422,8008440000,848635000,18338000,0.0,0.0,285821000,0,0,-29802000,4324000,15563000,15563000,15563000,0,-25478000,51931000,0,-10890000,161618000,0,15563000,1134456000,0,72272000,7958240000,8456040000,0,233890000,FY2003.FQ3,3
7,0,2004-02-25,2003-12,2.631,8067080000,1519404000,18909000,0.01,0.0,426669000,0,0,-29320000,5375000,72872000,72872000,76872000,0,-23945000,137021000,-4000000,-36204000,278174000,0,76872000,1946073000,0,11474000,7991380000,9911380000,0,289648000,FY2003.FQ4,4
8,0,2004-04-23,2004-03,2.164,8097880000,1169000000,18000000,0.01,0.01,361000000,0,2000000,-28000000,6000000,111000000,111000000,111000000,0,-22000000,110000000,0,21000000,187000000,0,109000000,1530000000,0,64000000,8080000000,8500000000,0,251000000,FY2004.FQ1,1
9,0,2004-07-23,2004-06,2.72,8134220000,1046000000,18000000,0.01,0.0,341000000,0,-5000000,-26000000,5000000,76000000,76000000,76000000,0,-21000000,86000000,0,16000000,190000000,0,81000000,1387000000,0,65000000,8100000000,8500000000,0,255000000,FY2004.FQ2,2
10,0,2004-10-22,2004-09,2.043,8149280000,1107000000,19000000,0.0,0.0,356000000,0,-3000000,-26000000,7000000,54000000,54000000,54000000,0,-19000000,81000000,0,-5000000,212000000,0,57000000,1463000000,0,63000000,8140000000,8500000000,0,275000000,FY2004.FQ3,3
11,0,2005-03-11,2004-12,2.215,8194220000,1997000000,21000000,0.04,0.04,544000000,0,239000000,-27000000,9000000,346000000,346000000,346000000,0,-18000000,162000000,0,-37000000,288000000,0,107000000,2541000000,0,94000000,8180000000,8560000000,0,382000000,FY2004.FQ4,4
12,0,2005-04-28,2005-03,1.714,8220000000,1444000000,28000000,0.01,0.0,458000000,0,-56000000,-26000000,9000000,52000000,52000000,52000000,0,-17000000,108000000,0,17000000,259000000,0,108000000,1902000000,0,91000000,8200000000,8480000000,0,350000000,FY2005.FQ1,1
13,0,2005-07-28,2005-06,1.655,8240000000,1303000000,26000000,0.0,0.0,450000000,0,-56000000,-22000000,9000000,52000000,52000000,52000000,0,-13000000,104000000,0,17000000,266000000,0,108000000,1753000000,0,80000000,8220000000,8500000000,0,346000000,FY2005.FQ2,2
14,0,2005-10-27,2005-09,2.265,8280000000,1395000000,30000000,0.0,0.0,463000000,0,-21000000,-22000000,12000000,30000000,30000000,30000000,0,-10000000,55000000,0,6000000,332000000,0,51000000,1858000000,0,76000000,8260000000,8560000000,0,408000000,FY2005.FQ3,3
15,0,2006-02-17,2005-12,2.358,8320000000,2310000000,36000000,0.02,0.02,667000000,0,38000000,-22000000,14000000,199000000,199000000,199000000,0,-8000000,165000000,0,4000000,386000000,0,161000000,2977000000,0,116000000,8300000000,8520000000,0,502000000,FY2005.FQ4,4
16,0,2006-04-27,2006-03,1.827,8340000000,1732000000,40000000,0.0,0.0,547000000,0,-45000000,-21000000,15000000,51000000,51000000,51000000,0,-6000000,106000000,0,-4000000,342000000,0,96000000,2279000000,0,99000000,8340000000,8520000000,0,441000000,FY2006.FQ1,1
17,0,2006-07-27,2006-06,1.942,8380000000,1630000000,43000000,0.0,0.0,509000000,0,-32000000,-19000000,13000000,22000000,22000000,22000000,0,-6000000,47000000,0,13000000,359000000,0,54000000,2139000000,0,103000000,8360000000,8520000000,0,462000000,FY2006.FQ2,2
18,0,2006-10-26,2006-09,1.606,8220000000,1758000000,63000000,0.0,0.0,549000000,0,-19000000,-21000000,14000000,19000000,19000000,19000000,0,-7000000,40000000,0,5000000,391000000,0,38000000,2307000000,0,118000000,8340000000,8480000000,0,509000000,FY2006.FQ3,3
19,0,2007-02-16,2006-12,1.973,8280000000,3136000000,59000000,0.01,0.01,850000000,0,-91000000,-20000000,18000000,97000000,97000000,97000000,0,-2000000,197000000,0,-7000000,516000000,0,188000000,3986000000,0,137000000,8260000000,8420000000,0,653000000,FY2006.FQ4,4
20,0,2007-04-26,2007-03,1.99,8193966000,2296000000,62000000,0.01,0.01,719000000,0,-33000000,-19000000,20000000,111000000,111000000,111000000,0,1000000,145000000,0,-2000000,446000000,0,144000000,3015000000,0,128000000,8240000000,8400000000,0,574000000,FY2007.FQ1,1
21,0,2007-07-26,2007-06,3.421,8267977000,2185000000,60000000,0.01,0.01,701000000,0,-33000000,-19000000,20000000,78000000,78000000,78000000,0,1000000,116000000,0,-6000000,462000000,0,111000000,2886000000,0,123000000,8240000000,8460000000,0,585000000,FY2007.FQ2,2
22,0,2007-10-25,2007-09,4.658,8303548000,2500000000,61000000,0.01,0.01,762000000,0,-44000000,-19000000,23000000,80000000,80000000,80000000,0,4000000,123000000,0,-3000000,508000000,0,124000000,3262000000,0,131000000,8280000000,8500000000,0,639000000,FY2007.FQ3,3
23,0,2008-02-11,2007-12,4.632,8320000000,4502000000,63000000,0.02,0.02,1170000000,0,-74000000,-20000000,28000000,207000000,207000000,207000000,0,8000000,271000000,0,2000000,702000000,0,281000000,5672000000,0,197000000,8320000000,8540000000,0,899000000,FY2007.FQ4,4
24,0,2008-04-25,2008-03,3.565,8340000000,3179000000,65000000,0.01,0.01,956000000,0,-62000000,-22000000,26000000,143000000,143000000,145000000,0,4000000,198000000,-2000000,5000000,594000000,0,207000000,4135000000,0,164000000,8340000000,8520000000,0,758000000,FY2008.FQ1,1
25,0,2008-07-25,2008-06,3.667,8520000000,3096000000,70000000,0.01,0.01,967000000,0,-46000000,-21000000,20000000,158000000,158000000,162000000,0,-1000000,217000000,-4000000,-8000000,574000000,0,208000000,4063000000,0,176000000,8400000000,8600000000,0,750000000,FY2008.FQ2,2
26,0,2008-10-22,2008-09,3.638,8620000000,3265000000,76000000,0.01,0.01,999000000,0,-59000000,-17000000,21000000,118000000,118000000,123000000,0,4000000,154000000,-5000000,24000000,664000000,0,182000000,4264000000,0,181000000,8540000000,8720000000,0,845000000,FY2008.FQ3,3
27,0,2009-01-30,2008-12,2.564,8571663000,5355000000,77000000,0.02,0.02,1348000000,0,-80000000,-11000000,16000000,225000000,225000000,223000000,0,5000000,273000000,2000000,25000000,835000000,0,303000000,6703000000,0,240000000,8580000000,8700000000,0,1075000000,FY2008.FQ4,4
28,0,2009-04-24,2009-03,3.672,8592951000,3741000000,87000000,0.02,0.02,1148000000,0,-69000000,-12000000,12000000,177000000,177000000,179000000,0,0,244000000,-2000000,4000000,708000000,0,248000000,4889000000,0,196000000,8580000000,8740000000,0,904000000,FY2009.FQ1,1
29,0,2009-07-24,2009-06,4.183,8640000000,3518000000,84000000,0.01,0.01,1133000000,0,-39000000,-7000000,8000000,142000000,142000000,140000000,0,1000000,159000000,2000000,19000000,768000000,0,179000000,4651000000,0,206000000,8620000000,8800000000,0,974000000,FY2009.FQ2,2
30,0,2009-10-23,2009-09,4.668,8660000000,4176000000,96000000,0.02,0.02,1273000000,0,-60000000,-7000000,7000000,199000000,199000000,202000000,0,0,251000000,-3000000,11000000,790000000,0,262000000,5449000000,0,232000000,8640000000,8820000000,0,1022000000,FY2009.FQ3,3
31,0,2010-01-29,2009-12,6.726,8880000000,7543000000,112000000,0.04,0.04,1977000000,0,-84000000,-8000000,9000000,384000000,384000000,387000000,0,1000000,476000000,-3000000,-6000000,1127000000,0,471000000,9520000000,0,374000000,8780000000,9020000000,0,1501000000,FY2009.FQ4,4
32,0,2010-04-23,2010-03,6.789,8920000000,5501000000,119000000,0.03,0.03,1630000000,0,-100000000,-7000000,11000000,299000000,299000000,301000000,0,4000000,394000000,-2000000,3000000,938000000,0,401000000,7131000000,0,298000000,8900000000,9080000000,0,1236000000,FY2010.FQ1,1
33,0,2010-07-23,2010-06,5.463,8960000000,4957000000,129000000,0.02,0.02,1609000000,0,-88000000,-9000000,12000000,207000000,207000000,209000000,0,3000000,270000000,-2000000,24000000,1015000000,0,297000000,6566000000,0,324000000,8940000000,9100000000,0,1339000000,FY2010.FQ2,2
34,0,2010-10-22,2010-09,7.853,8980000000,5786000000,150000000,0.02,0.02,1774000000,0,-79000000,-11000000,13000000,231000000,231000000,213000000,0,2000000,268000000,18000000,22000000,1148000000,0,292000000,7560000000,0,358000000,8960000000,9120000000,0,1506000000,FY2010.FQ3,3
35,0,2011-01-28,2010-12,9.0,9020000000,10317000000,169000000,0.04,0.04,2630000000,0,-85000000,-11000000,15000000,416000000,416000000,422000000,0,4000000,474000000,-6000000,29000000,1637000000,0,507000000,12947000000,0,519000000,8940000000,9180000000,0,2156000000,FY2010.FQ4,4
36,0,2011-04-27,2011-03,9.007,9040000000,7608000000,202000000,0.02,0.02,2249000000,0,-89000000,-12000000,15000000,201000000,201000000,218000000,0,3000000,322000000,-17000000,-18000000,1467000000,0,307000000,9857000000,0,460000000,9020000000,9180000000,0,1927000000,FY2011.FQ1,1
37,0,2011-07-27,2011-06,10.225,9080000000,7525000000,244000000,0.02,0.02,2388000000,0,-49000000,-15000000,16000000,191000000,191000000,176000000,0,1000000,201000000,15000000,23000000,1680000000,0,225000000,9913000000,0,507000000,9060000000,9200000000,0,2187000000,FY2011.FQ2,2
38,0,2011-10-26,2011-09,10.812,9100000000,8325000000,278000000,0.0,0.0,2551000000,0,-67000000,-17000000,16000000,63000000,63000000,63000000,0,-1000000,79000000,0,52000000,1927000000,0,130000000,10876000000,0,545000000,9080000000,9220000000,0,2472000000,FY2011.FQ3,3
39,0,2012-02-01,2011-12,8.655,9100000000,13831000000,359000000,0.02,0.01,3600000000,0,-86000000,-20000000,14000000,177000000,177000000,187000000,0,-6000000,260000000,-10000000,19000000,2563000000,0,273000000,17431000000,0,777000000,9060000000,9280000000,0,3340000000,FY2011.FQ4,4
40,0,2012-04-27,2012-03,10.126,9000000000,10027000000,457000000,0.01,0.01,3158000000,0,-43000000,-21000000,12000000,130000000,130000000,41000000,0,-9000000,192000000,89000000,-99000000,2286000000,0,84000000,13185000000,0,680000000,9060000000,9200000000,0,2966000000,FY2012.FQ1,1
41,0,2012-07-27,2012-06,11.418,9040000000,9488000000,485000000,0.0,0.0,3346000000,0,-109000000,-21000000,10000000,7000000,7000000,37000000,0,-11000000,107000000,-30000000,50000000,2470000000,0,146000000,12834000000,0,769000000,9020000000,9160000000,0,3239000000,FY2012.FQ2,2
42,0,2012-10-26,2012-09,12.716,9060000000,10319000000,554000000,-0.03,-0.03,3487000000,0,-83000000,-22000000,10000000,-274000000,-274000000,-105000000,0,-12000000,-28000000,-169000000,18000000,2745000000,0,-22000000,13806000000,0,770000000,9040000000,9040000000,0,3515000000,FY2012.FQ3,3
43,0,2013-01-30,2012-12,12.544,9080000000,16137000000,662000000,0.01,0.01,5131000000,0,-194000000,-27000000,8000000,98000000,98000000,143000000,0,-19000000,405000000,-45000000,-49000000,3641000000,0,337000000,21268000000,0,1085000000,9120000000,9120000000,0,4726000000,FY2012.FQ4,4
44,0,2013-04-26,2013-03,13.325,9100000000,11801000000,700000000,0.0,0.0,4269000000,0,18000000,-33000000,10000000,82000000,82000000,99000000,0,-23000000,181000000,-17000000,-77000000,3210000000,0,81000000,16070000000,0,878000000,9100000000,9260000000,0,4088000000,FY2013.FQ1,1
45,0,2013-07-26,2013-06,13.885,9140000000,11209000000,756000000,0.0,0.0,4495000000,0,-13000000,-33000000,9000000,-7000000,-7000000,4000000,0,-24000000,79000000,-11000000,-38000000,3455000000,0,17000000,15704000000,0,961000000,9120000000,9120000000,0,4416000000,FY2013.FQ2,2
46,0,2013-10-25,2013-09,15.632,9160000000,12366000000,834000000,0.0,0.0,4726000000,0,12000000,-36000000,9000000,-41000000,-41000000,-31000000,0,-27000000,-25000000,-10000000,9000000,3779000000,0,-43000000,17092000000,0,972000000,9140000000,9140000000,0,4751000000,FY2013.FQ3,3
47,0,2014-01-31,2013-12,19.94,9180000000,18806000000,962000000,0.02,0.02,6781000000,0,-179000000,-39000000,10000000,240000000,240000000,273000000,0,-29000000,510000000,-33000000,-29000000,4820000000,0,452000000,25587000000,0,1451000000,9200000000,9360000000,0,6271000000,FY2013.FQ4,4
48,0,2014-04-25,2014-03,16.818,9200000000,14055000000,1010000000,0.01,0.01,5686000000,0,-73000000,-42000000,11000000,108000000,108000000,47000000,0,-31000000,146000000,61000000,5000000,4343000000,0,120000000,19741000000,0,1197000000,9200000000,9360000000,0,5540000000,FY2014.FQ1,1
49,0,2014-07-25,2014-06,16.239,9240000000,13399000000,1109000000,-0.01,-0.01,5941000000,0,-94000000,-45000000,11000000,-126000000,-126000000,-121000000,0,-34000000,-15000000,-5000000,22000000,4636000000,0,-27000000,19340000000,0,1320000000,9220000000,9220000000,0,5956000000,FY2014.FQ2,2
50,0,2014-10-24,2014-09,16.122,9260000000,14627000000,1247000000,-0.04,-0.04,5952000000,0,205000000,-49000000,9000000,-437000000,-437000000,-429000000,0,-40000000,-544000000,-8000000,-50000000,5097000000,0,-634000000,20579000000,0,1399000000,9260000000,9260000000,0,6496000000,FY2014.FQ3,3
51,0,2015-01-30,2014-12,15.518,9300000000,20672000000,1380000000,0.02,0.02,8657000000,0,-205000000,-74000000,8000000,214000000,214000000,224000000,0,-66000000,590000000,-10000000,-95000000,6099000000,0,429000000,29329000000,0,1968000000,9300000000,9300000000,0,8067000000,FY2014.FQ4,4
52,0,2015-04-24,2015-03,18.605,9320000000,15395000000,1426000000,0.0,0.0,7322000000,0,-71000000,-115000000,11000000,-57000000,-57000000,-50000000,0,-104000000,255000000,-7000000,-130000000,5557000000,0,21000000,22717000000,0,1510000000,9300000000,9300000000,0,7067000000,FY2015.FQ1,1
53,0,2015-07-24,2015-06,21.705,9360000000,15160000000,1504000000,0.01,0.01,8025000000,0,-266000000,-114000000,12000000,92000000,92000000,96000000,0,-102000000,464000000,-4000000,0,5944000000,0,362000000,23185000000,0,1617000000,9340000000,9520000000,0,7561000000,FY2015.FQ2,2
54,0,2015-10-23,2015-09,25.595,9380000000,16755000000,1599000000,0.0,0.0,8603000000,0,-161000000,-116000000,13000000,79000000,79000000,86000000,0,-103000000,406000000,-7000000,-56000000,6470000000,0,247000000,25358000000,0,1727000000,9360000000,9560000000,0,8197000000,FY2015.FQ3,3
55,0,2016-01-29,2015-12,33.795,9420000000,24341000000,1752000000,0.05,0.05,11406000000,0,-452000000,-115000000,13000000,482000000,482000000,486000000,0,-102000000,1109000000,-4000000,-69000000,8149000000,0,938000000,35747000000,0,2148000000,9340000000,9600000000,0,10297000000,FY2015.FQ4,4
56,0,2016-04-29,2016-03,29.682,9440000000,18866000000,1827000000,0.05,0.05,10262000000,0,-475000000,-117000000,21000000,513000000,513000000,581000000,0,-96000000,1071000000,-68000000,81000000,7258000000,0,1056000000,29128000000,0,1933000000,9420000000,9620000000,0,9191000000,FY2016.FQ1,1
57,0,2016-07-29,2016-06,35.781,9480000000,19180000000,1909000000,0.09,0.08,11224000000,0,-307000000,-116000000,24000000,857000000,857000000,872000000,0,-92000000,1285000000,-15000000,-14000000,7813000000,0,1179000000,30404000000,0,2126000000,9460000000,9660000000,0,9939000000,FY2016.FQ2,2
58,0,2016-10-28,2016-09,41.866,9500000000,21260000000,2084000000,0.02,0.02,11454000000,0,-229000000,-118000000,26000000,252000000,252000000,262000000,0,-92000000,575000000,-10000000,8000000,8502000000,0,491000000,32714000000,0,2377000000,9480000000,9700000000,0,10879000000,FY2016.FQ3,3
59,0,2017-02-10,2016-12,37.494,9540000000,28959000000,2297000000,0.07,0.07,14782000000,0,-413000000,-133000000,29000000,749000000,749000000,753000000,0,-104000000,1255000000,-4000000,15000000,10297000000,0,1166000000,43741000000,0,3230000000,9540000000,9740000000,0,13527000000,FY2016.FQ4,4
60,0,2017-04-28,2017-03,44.327,9560000000,22440000000,2435000000,0.07,0.07,13274000000,0,-229000000,-139000000,39000000,724000000,724000000,724000000,0,-100000000,1005000000,0,48000000,9554000000,0,953000000,35714000000,0,2715000000,9540000000,9800000000,0,12269000000,FY2017.FQ1,1
61,0,2017-07-28,2017-06,48.4,9600000000,23451000000,2633000000,0.02,0.02,14504000000,0,-467000000,-143000000,44000000,197000000,197000000,199000000,0,-99000000,628000000,-2000000,137000000,10773000000,0,666000000,37955000000,0,3103000000,9580000000,9840000000,0,13876000000,FY2017.FQ2,2
62,0,2017-10-27,2017-09,48.068,9640000000,27549000000,2912000000,0.02,0.02,16195000000,0,-58000000,-228000000,54000000,256000000,256000000,258000000,0,-174000000,347000000,-2000000,143000000,12409000000,0,316000000,43744000000,0,3439000000,9620000000,9880000000,0,15848000000,FY2017.FQ3,3
63,0,2018-02-02,2017-12,58.474,9680000000,38495000000,3498000000,0.19,0.18,21958000000,0,-14000000,-338000000,65000000,1857000000,1857000000,1857000000,0,-273000000,2127000000,0,17000000,15347000000,0,1871000000,60453000000,0,4484000000,9660000000,9920000000,0,19831000000,FY2017.FQ4,4
64,0,2018-04-27,2018-03,72.367,9700000000,30735000000,3671000000,0.16,0.16,20307000000,0,-287000000,-330000000,80000000,1629000000,1629000000,1629000000,0,-250000000,1927000000,0,239000000,14614000000,0,1916000000,51042000000,0,3766000000,9680000000,9960000000,0,18380000000,FY2018.FQ1,1
65,0,2018-07-27,2018-06,84.99,9740000000,30632000000,3630000000,0.26,0.25,22254000000,0,-74000000,-343000000,94000000,2534000000,2534000000,2531000000,0,-249000000,2983000000,3000000,-129000000,15259000000,0,2605000000,52886000000,0,4012000000,9720000000,10000000000,0,19271000000,FY2018.FQ2,2
66,0,2018-10-26,2018-09,100.15,9780000000,33003000000,3778000000,0.29,0.28,23573000000,0,-508000000,-358000000,117000000,2883000000,2883000000,2882000000,0,-241000000,3724000000,1000000,-93000000,15505000000,0,3390000000,56576000000,0,4344000000,9760000000,10020000000,0,19849000000,FY2018.FQ3,3
67,0,2019-02-01,2018-12,75.099,9820000000,44786000000,4262000000,0.3,0.3,27597000000,0,-327000000,-387000000,150000000,3027000000,3027000000,3023000000,0,-237000000,3786000000,4000000,-199000000,17782000000,0,3350000000,72383000000,0,6029000000,9800000000,10000000000,0,23811000000,FY2018.FQ4,4
68,0,2019-04-26,2019-03,89.038,9840000000,33920000000,4854000000,0.36,0.35,25780000000,0,-836000000,-366000000,183000000,3561000000,3561000000,3565000000,0,-183000000,4420000000,-4000000,164000000,16523000000,0,4401000000,59700000000,0,4837000000,9820000000,10040000000,0,21360000000,FY2019.FQ1,1
69,0,2019-07-26,2019-06,94.682,9880000000,36337000000,5202000000,0.26,0.26,27067000000,0,-257000000,-383000000,215000000,2625000000,2625000000,2632000000,0,-168000000,3084000000,-7000000,-27000000,18422000000,0,2889000000,63404000000,0,5561000000,9860000000,10060000000,0,23983000000,FY2019.FQ2,2
70,0,2019-10-25,2019-09,86.796,9900000000,41302000000,5563000000,0.21,0.21,28679000000,0,-494000000,-396000000,224000000,2134000000,2134000000,2138000000,0,-172000000,3157000000,-4000000,-353000000,19422000000,0,2632000000,69981000000,0,6100000000,9900000000,10080000000,0,25522000000,FY2019.FQ3,3
71,0,2020-01-31,2019-12,92.392,9960000000,53977000000,6170000000,0.32,0.32,33459000000,0,-786000000,-455000000,211000000,3268000000,3268000000,3267000000,0,-244000000,3879000000,1000000,418000000,21997000000,0,4053000000,87436000000,0,7583000000,9940000000,10140000000,0,29580000000,FY2019.FQ4,4
72,0,2020-05-01,2020-03,97.486,9980000000,44257000000,5362000000,0.25,0.25,31195000000,0,-744000000,-402000000,202000000,2535000000,2535000000,2639000000,0,-200000000,3989000000,-104000000,-406000000,20926000000,0,3383000000,75452000000,0,6280000000,9960000000,10120000000,0,27206000000,FY2020.FQ1,1
73,0,2020-07-31,2020-06,137.941,10020000000,52660000000,5748000000,0.52,0.51,36252000000,0,-984000000,-403000000,135000000,5243000000,5243000000,5237000000,0,-268000000,5843000000,6000000,646000000,24484000000,0,6221000000,88912000000,0,5925000000,10000000000,10180000000,0,30409000000,FY2020.FQ2,2
74,0,2020-10-30,2020-09,157.437,10040000000,57106000000,6523000000,0.63,0.61,39039000000,0,-569000000,-428000000,118000000,6331000000,6331000000,6240000000,0,-310000000,6194000000,91000000,925000000,25743000000,0,6809000000,96145000000,0,7102000000,10020000000,10240000000,0,32845000000,FY2020.FQ3,3
75,0,2021-02-03,2020-12,162.847,10060000000,79284000000,7547000000,0.71,0.7,46271000000,0,-565000000,-414000000,100000000,7222000000,7222000000,7200000000,0,-314000000,6873000000,22000000,1206000000,30027000000,0,7765000000,125555000000,0,9371000000,10020000000,10252000000,0,39398000000,FY2020.FQ4,4
76,0,2021-04-30,2021-03,154.704,10071960000,62403000000,7508000000,0.8,0.79,46115000000,0,-2156000000,-399000000,105000000,8107000000,8107000000,8112000000,0,-294000000,8865000000,-5000000,1697000000,29056000000,0,10268000000,108518000000,0,8194000000,10080000000,10260000000,0,37250000000,FY2021.FQ1,1
77,0,2021-07-30,2021-06,172.008,10120000000,64176000000,8038000000,0.77,0.76,48904000000,0,-868000000,-435000000,106000000,7778000000,7778000000,7766000000,0,-329000000,7702000000,12000000,1261000000,31520000000,0,8634000000,113080000000,0,9682000000,10103000000,10286000000,0,41202000000,FY2021.FQ2,2
78,0,2021-10-29,2021-09,164.252,10140000000,62930000000,8948000000,0.31,0.31,47882000000,0,-1155000000,-493000000,119000000,3156000000,3156000000,3160000000,0,-374000000,4852000000,-4000000,-163000000,32867000000,0,4315000000,110812000000,0,10163000000,10132000000,10309000000,0,43030000000,FY2021.FQ3,3
79,0,2022-02-04,2021-12,166.717,10180000000,82835000000,9939000000,1.41,1.38,54577000000,0,-612000000,-482000000,118000000,14323000000,14323000000,14322000000,0,-364000000,3460000000,1000000,11838000000,37782000000,0,14934000000,137412000000,0,13335000000,10159000000,10323000000,0,51117000000,FY2021.FQ4,4
80,0,2022-04-29,2022-03,162.998,10180000000,66499000000,9193000000,-0.38,-0.38,49945000000,0,1422000000,-472000000,108000000,-3844000000,-3844000000,-3843000000,0,-364000000,3669000000,-1000000,-8570000000,35362000000,0,-5265000000,116444000000,0,10914000000,10171000000,10171000000,0,46276000000,FY2022.FQ1,1
81,0,2022-07-29,2022-06,106.21,10183000000,66424000000,9716000000,-0.2,-0.2,54810000000,0,637000000,-584000000,159000000,-2028000000,-2028000000,-2016000000,0,-425000000,3317000000,-12000000,-5545000000,38504000000,0,-2653000000,121234000000,0,12989000000,10175000000,10175000000,0,51493000000,FY2022.FQ2,2
82,0,2022-10-28,2022-09,113.0,10198000000,70268000000,10327000000,0.28,0.28,56833000000,0,-69000000,-617000000,277000000,2872000000,2872000000,2875000000,0,-340000000,2525000000,-3000000,759000000,40233000000,0,2944000000,127101000000,0,14075000000,10191000000,10331000000,0,54308000000,FY2022.FQ3,3
83,0,2023-02-03,2022-12,84.0,10242000000,85640000000,12685000000,0.03,0.03,63564000000,0,1227000000,-694000000,445000000,278000000,278000000,265000000,0,-249000000,2737000000,13000000,-3450000000,44676000000,0,-962000000,149204000000,0,16151000000,10222000000,10222000000,0,60827000000,FY2022.FQ4,4
84,0,2023-04-28,2023-03,103.29,10258000000,67791000000,11123000000,0.31,0.31,59567000000,0,-948000000,-823000000,611000000,3172000000,3172000000,3171000000,0,-212000000,4774000000,1000000,-443000000,41578000000,0,4119000000,127358000000,0,13215000000,10250000000,10347000000,0,54793000000,FY2023.FQ1,1
85,0,2023-08-04,2023-06,130.36,10313000000,69373000000,11589000000,0.66,0.65,65010000000,0,-804000000,-840000000,661000000,6750000000,6750000000,6759000000,0,-179000000,7681000000,-9000000,61000000,43382000000,0,7563000000,134383000000,0,13947000000,10285000000,10449000000,0,57329000000,FY2023.FQ2,2
86,0,2023-10-27,2023-09,127.12,10330000000,75022000000,12131000000,0.96,0.94,68061000000,0,-2306000000,-806000000,776000000,9879000000,9879000000,9883000000,0,-30000000,11188000000,-4000000,1031000000,43761000000,0,12189000000,143083000000,0,13112000000,10322000000,10558000000,0,56873000000,FY2023.FQ3,3
87,0,2024-02-02,2023-12,151.94,10383000000,92553000000,13820000000,1.03,1.0,77408000000,0,-3062000000,-713000000,901000000,10624000000,10624000000,10624000000,0,188000000,13209000000,0,289000000,48287000000,0,13686000000,169961000000,0,15912000000,10358000000,10612000000,0,64199000000,FY2023.FQ4,4
88,0,2024-05-01,2024-03,180.38,10403000000,72633000000,11684000000,1.0,0.98,70680000000,0,-2467000000,-644000000,993000000,10431000000,10431000000,10516000000,0,349000000,15307000000,-85000000,-2673000000,42969000000,0,12983000000,143313000000,0,12404000000,10393000000,10670000000,0,55373000000,FY2024.FQ1,1
89,0,2024-08-02,2024-06,193.25,10490000000,73785000000,12038000000,1.29,1.26,74192000000,0,-1767000000,-589000000,1180000000,13485000000,13485000000,13478000000,0,591000000,14672000000,7000000,-18000000,45967000000,0,15245000000,147977000000,0,13553000000,10447000000,10708000000,0,59520000000,FY2024.FQ2,2
90,0,2024-11-01,2024-09,186.33,10511000000,80977000000,13442000000,1.46,1.43,77900000000,0,-2706000000,-603000000,1256000000,15328000000,15328000000,15331000000,0,653000000,17411000000,-3000000,-27000000,47167000000,0,18037000000,158877000000,0,13322000000,10501000000,10735000000,0,60489000000,FY2024.FQ3,3
91,0,2025-02-07,2024-12,219.39,10593000000,98893000000,15631000000,1.9,1.86,88899000000,0,-2325000000,-570000000,1248000000,20004000000,20004000000,20024000000,0,678000000,21203000000,-20000000,468000000,51709000000,0,22349000000,187792000000,0,15987000000,10551000000,10769000000,0,67696000000,FY2024.FQ4,4
92,0,2025-05-02,2025-03,190.26,10613000000,76976000000,14262000000,1.62,1.59,78691000000,0,-4553000000,-541000000,1066000000,17127000000,17127000000,17126000000,0,525000000,18405000000,1000000,2749000000,47895000000,0,21679000000,155667000000,0,12391000000,10603000000,10793000000,0,60286000000,FY2025.FQ1,1
