,dividends,original_filing_date,period_end_date,period_end_price,shares_eop,cogs,da_income_statement_supplemental,eps_basic,eps_diluted,gross_profit,income_allocated_to_minority_interest,income_tax,interest_expense,interest_income,net_income,net_income_available_to_shareholders,net_income_continuing,net_income_discontinued,net_interest_income_normal,operating_income,other_income_statement_items,other_nonoperating_income,other_opex,preferred_dividends,pretax_income,revenue,rnd,sga,shares_basic,shares_diluted,special_charges,total_opex,fiscal_quarter_key,fiscal_quarter_number
0,0.0,2010-05-17,2009-03,0.0,611000000,24611000000,0,-9.78,-9.78,-2180000000,-76000000,114000000,-1230000000,425000000,-5975000000,-5975000000,-5947000000,0,-805000000,-4677000000,48000000,-579000000,0,0,-6061000000,22431000000,0,2497000000,611000000,611000000,0,2497000000,FY2009.FQ1,1
1,0.0,2010-08-18,2009-06,0.0,611000000,29384000000,0,-21.12,-21.12,-6337000000,332000000,445000000,-3375000000,408000000,-12905000000,-12905000000,-13235000000,0,-2967000000,-10427000000,-2000000,-286000000,1154000000,0,-13680000000,23047000000,0,2936000000,611000000,611000000,0,4090000000,FY2009.FQ2,2
2,0.0,2010-11-18,2009-09,0.0,611000000,25373000000,0,208.0,208.0,1411000000,-428000000,746000000,-1188000000,473000000,127140000000,127140000000,127349000000,0,-715000000,-1994000000,219000000,129312000000,41000000,0,126603000000,26784000000,0,3364000000,611000000,611000000,0,3405000000,FY2009.FQ3,3
3,0.0,2010-11-18,2009-12,0.0,1581000000,32827000000,0,-2.27,-2.27,-500000000,-224000000,861000000,-329000000,-14000000,-3439000000,-3520000000,-3508000000,0,-343000000,-3925000000,293000000,-101000000,-1195000000,81000000,-4369000000,32327000000,0,4620000000,1548000000,1581000000,0,3425000000,FY2009.FQ4,4
4,0.0,2010-05-17,2010-03,0.0,1581000000,27553000000,0,0.55,0.54,3923000000,-128000000,-509000000,-337000000,447000000,1068000000,865000000,793000000,0,110000000,1193000000,403000000,-1000000,0,203000000,1302000000,31476000000,0,2730000000,1548000000,1581000000,0,2730000000,FY2010.FQ1,1
5,0.0,2010-08-18,2010-06,0.0,1500000000,28609000000,0,2.66,2.55,4565000000,-76000000,-361000000,-250000000,0,1536000000,1334000000,1201000000,0,-250000000,1903000000,411000000,-91000000,0,202000000,1562000000,33174000000,0,2662000000,500000000,522000000,0,2662000000,FY2010.FQ2,2
6,0.0,2010-11-18,2010-09,0.0,1500000000,29587000000,0,1.3,1.3,4473000000,-61000000,25000000,-263000000,377000000,2162000000,1959000000,1872000000,0,114000000,1733000000,351000000,0,0,203000000,1847000000,34060000000,0,2740000000,1500000000,1500000000,0,2740000000,FY2010.FQ3,3
7,0.0,2011-03-01,2010-12,36.86,1500137000,33170000000,0,0.34,0.34,3712000000,-66000000,173000000,-248000000,-269000000,1406000000,510000000,1199000000,0,-517000000,280000000,273000000,1263000000,118000000,896000000,1026000000,36882000000,0,3314000000,1500137000,1500137000,0,3432000000,FY2010.FQ4,4
8,0.0,2011-05-06,2011-03,31.03,1560756000,31850000000,0,2.09,1.77,4344000000,-45000000,-137000000,-149000000,604000000,3366000000,3151000000,1267000000,0,455000000,1344000000,2144000000,-395000000,0,215000000,1404000000,36194000000,0,3000000000,1504000000,1817000000,0,3000000000,FY2011.FQ1,1
9,0.0,2011-08-05,2011-06,30.36,1561450000,33979000000,0,1.68,1.54,5394000000,-45000000,61000000,-155000000,308000000,2992000000,2524000000,2655000000,0,153000000,2451000000,382000000,-10000000,0,468000000,2594000000,39373000000,0,2943000000,1505000000,1654000000,0,2943000000,FY2011.FQ2,2
10,0.0,2011-11-09,2011-09,20.18,1564367000,31946000000,0,1.1,1.03,4773000000,15000000,-107000000,-101000000,152000000,2107000000,1726000000,1715000000,0,51000000,1806000000,377000000,-35000000,0,381000000,1822000000,36719000000,0,2967000000,1562000000,1682000000,0,2967000000,FY2011.FQ3,3
11,0.0,2012-02-27,2011-12,20.27,1564727000,33396000000,0,0.27,0.27,4594000000,-22000000,293000000,-135000000,-609000000,725000000,1218000000,3650000000,0,-744000000,1341000000,-2903000000,2760000000,0,-493000000,3357000000,37990000000,0,3253000000,1572000000,1668000000,0,3253000000,FY2011.FQ4,4
12,0.0,2012-05-03,2012-03,25.65,1565843000,33158000000,0,0.64,0.6,4601000000,-35000000,-216000000,-110000000,275000000,1315000000,1004000000,927000000,0,165000000,1613000000,423000000,-635000000,15000000,311000000,1143000000,37759000000,0,2973000000,1572000000,1692000000,0,2988000000,FY2012.FQ1,1
13,0.0,2012-08-03,2012-06,19.72,1565941000,32946000000,0,0.95,0.9,4668000000,-55000000,-241000000,-118000000,139000000,1846000000,1632000000,1601000000,0,21000000,1821000000,300000000,0,0,214000000,1842000000,37614000000,0,2847000000,1569000000,1671000000,0,2847000000,FY2012.FQ2,2
14,0.0,2012-10-31,2012-09,22.75,1565980000,33046000000,0,0.94,0.89,4530000000,-21000000,-357000000,-128000000,318000000,1833000000,1618000000,1436000000,0,190000000,1681000000,418000000,-78000000,0,215000000,1793000000,37576000000,0,2849000000,1570000000,1663000000,0,2849000000,FY2012.FQ3,3
15,0.0,2013-02-15,2012-12,28.83,1366374000,42293000000,0,0.57,0.54,-2986000000,163000000,35645000000,-133000000,-389000000,1194000000,979000000,2172000000,0,-522000000,-8333000000,-1141000000,-24618000000,0,215000000,-33473000000,39307000000,0,5347000000,1554000000,1675000000,0,5347000000,FY2012.FQ4,4
16,0.0,2013-05-02,2013-03,27.82,1400000000,32973000000,0,0.63,0.58,3911000000,-10000000,-409000000,-91000000,171000000,1175000000,960000000,1185000000,0,80000000,959000000,0,555000000,0,215000000,1594000000,36884000000,0,2952000000,1372000000,1507000000,0,2952000000,FY2013.FQ1,1
17,0.0,2013-07-25,2013-06,33.31,1400000000,34399000000,0,0.87,0.75,4676000000,26000000,-742000000,-61000000,251000000,1414000000,1200000000,1388000000,0,190000000,1751000000,0,189000000,0,214000000,2130000000,39075000000,0,2925000000,1376000000,1677000000,0,2925000000,FY2013.FQ2,2
18,0.0,2013-10-30,2013-09,35.97,1400000000,33791000000,0,0.5,0.45,5192000000,12000000,-842000000,-65000000,-82000000,1717000000,698000000,1705000000,0,-147000000,2316000000,0,378000000,0,1019000000,2547000000,38983000000,0,2876000000,1386000000,1681000000,0,2876000000,FY2013.FQ3,3
19,0.0,2014-02-06,2013-12,40.87,1500000000,36210000000,0,0.64,0.56,4275000000,-13000000,-134000000,-117000000,-94000000,1040000000,913000000,1053000000,0,-211000000,646000000,0,752000000,0,127000000,1187000000,40485000000,0,3629000000,1438000000,1688000000,0,3629000000,FY2013.FQ4,4
20,0.3,2014-04-24,2014-03,34.42,1600000000,35002000000,0,0.08,0.06,2406000000,-67000000,224000000,-103000000,89000000,213000000,125000000,280000000,0,-14000000,-535000000,0,605000000,0,88000000,56000000,37408000000,0,2941000000,1587000000,1691000000,0,2941000000,FY2014.FQ1,1
21,0.3,2014-07-24,2014-06,36.3,1600000000,36777000000,0,0.12,0.11,2872000000,-9000000,254000000,-100000000,81000000,278000000,190000000,287000000,0,-19000000,-471000000,0,523000000,0,88000000,33000000,39649000000,0,3343000000,1608000000,1688000000,0,3343000000,FY2014.FQ2,2
22,0.3,2014-10-23,2014-09,31.94,1600000000,35107000000,0,0.86,0.81,4148000000,29000000,-427000000,-96000000,239000000,1471000000,1384000000,1442000000,0,143000000,1227000000,0,499000000,0,87000000,1869000000,39255000000,0,2921000000,1612000000,1691000000,0,2921000000,FY2014.FQ3,3
23,0.3,2015-02-04,2014-12,34.91,1600000000,35235000000,0,0.69,0.66,4382000000,-22000000,-279000000,-104000000,-198000000,1987000000,1105000000,2009000000,0,-302000000,1429000000,0,1161000000,0,882000000,2288000000,39617000000,0,2953000000,1611000000,1678000000,0,2953000000,FY2014.FQ4,4
24,0.3,2015-04-23,2015-03,37.5,1600000000,31842000000,1757000000,0.58,0.56,3870000000,37000000,-529000000,-110000000,241000000,945000000,945000000,908000000,0,131000000,753000000,0,553000000,0,0,1437000000,35712000000,0,3117000000,1617000000,1686000000,0,3117000000,FY2015.FQ1,1
25,0.36,2015-07-23,2015-06,33.33,1583997000,33915000000,2170000000,0.7,0.67,4265000000,-23000000,-577000000,-108000000,13000000,1117000000,1117000000,1140000000,0,-95000000,1288000000,0,524000000,0,0,1717000000,38180000000,0,2977000000,1596000000,1660000000,0,2977000000,FY2015.FQ2,2
26,0.36,2015-10-21,2015-09,30.02,1600000000,33564000000,1981000000,0.86,0.84,5279000000,18000000,-165000000,-112000000,119000000,1359000000,1359000000,1341000000,0,7000000,997000000,0,502000000,0,0,1506000000,38843000000,0,4282000000,1577000000,1618000000,0,4282000000,FY2015.FQ3,3
27,0.36,2016-02-03,2015-12,34.01,1500000000,18978000000,1579000000,3.97,3.84,4012000000,40000000,2490000000,-93000000,241000000,6266000000,6266000000,6201000000,0,148000000,2500000000,25000000,1063000000,0,0,3711000000,22990000000,0,1512000000,1553000000,1595000000,0,1512000000,FY2015.FQ4,4
28,0.38,2016-04-21,2016-03,31.43,1500000000,32475000000,2292000000,1.26,1.24,4790000000,22000000,-559000000,-127000000,85000000,1953000000,1953000000,1931000000,0,-42000000,1972000000,0,560000000,0,0,2490000000,37265000000,0,2818000000,1546000000,1580000000,0,2818000000,FY2016.FQ1,1
29,0.38,2016-07-21,2016-06,28.3,1600000000,31903000000,2299000000,1.85,1.81,5480000000,16000000,-877000000,-144000000,133000000,2866000000,2866000000,2744000000,106000000,-11000000,2972000000,0,660000000,0,0,3621000000,37383000000,0,2508000000,1548000000,1581000000,0,2508000000,FY2016.FQ2,2
30,0.38,2016-10-25,2016-09,31.77,1500000000,33341000000,2534000000,1.79,1.76,5548000000,61000000,-902000000,-145000000,109000000,2773000000,2773000000,2707000000,5000000,-36000000,3148000000,0,497000000,0,0,3609000000,38889000000,0,2400000000,1550000000,1574000000,0,2400000000,FY2016.FQ3,3
31,0.38,2017-02-07,2016-12,34.84,1500000000,36454000000,2694000000,1.22,1.19,3442000000,60000000,-303000000,-150000000,-113000000,1835000000,1835000000,1895000000,-120000000,-263000000,475000000,0,1986000000,0,0,2198000000,39896000000,0,2967000000,1516000000,1546000000,0,2967000000,FY2016.FQ4,4
32,0.38,2017-04-28,2017-03,35.36,1500000000,32327000000,2743000000,1.73,1.7,4939000000,-9000000,-787000000,-147000000,482000000,2608000000,2608000000,2686000000,-69000000,335000000,2583000000,0,555000000,0,0,3473000000,37266000000,0,2356000000,1505000000,1532000000,0,2356000000,FY2017.FQ1,1
33,0.38,2017-07-25,2017-06,34.93,1500000000,32210000000,3194000000,1.11,1.09,4774000000,-3000000,-534000000,-132000000,272000000,1660000000,1660000000,2433000000,-770000000,140000000,2297000000,0,530000000,0,0,2967000000,36984000000,0,2477000000,1497000000,1519000000,0,2477000000,FY2017.FQ2,2
34,0.38,2017-10-24,2017-09,40.38,1400000000,29744000000,3147000000,-2.06,-2.06,3879000000,1000000,-2316000000,-151000000,505000000,-2981000000,-2983000000,114000000,-3096000000,354000000,1576000000,0,500000000,0,2000000,2430000000,33623000000,0,2303000000,1445000000,1472000000,0,2303000000,FY2017.FQ3,3
35,0.38,2018-02-06,2017-12,40.99,1400000000,33076000000,3177000000,-3.52,-3.52,4639000000,29000000,-7896000000,-145000000,-993000000,-5151000000,-5165000000,-4903000000,-277000000,-1138000000,2205000000,0,1926000000,0,14000000,2993000000,37715000000,0,2434000000,1411000000,1447000000,0,2434000000,FY2017.FQ4,4
36,0.38,2018-04-26,2018-03,36.34,1400000000,33198000000,3581000000,0.73,0.72,2901000000,6000000,-466000000,-150000000,549000000,1046000000,1032000000,1110000000,-70000000,399000000,529000000,0,648000000,0,14000000,1576000000,36099000000,0,2372000000,1408000000,1430000000,0,2372000000,FY2018.FQ1,1
37,0.38,2018-07-25,2018-06,39.4,1400000000,33067000000,3129000000,1.68,1.66,3693000000,24000000,-519000000,-159000000,930000000,2390000000,2375000000,2366000000,0,771000000,1477000000,0,637000000,0,15000000,2885000000,36760000000,0,2216000000,1410000000,1431000000,0,2216000000,FY2018.FQ2,2
38,0.38,2018-10-31,2018-09,33.67,1400000000,31597000000,3313000000,1.77,1.75,4194000000,4000000,-100000000,-161000000,651000000,2534000000,2503000000,2530000000,0,490000000,1610000000,0,530000000,0,31000000,2630000000,35791000000,0,2584000000,1412000000,1431000000,0,2584000000,FY2018.FQ3,3
39,0.38,2019-02-06,2018-12,33.45,1400000000,35092000000,3646000000,1.42,1.4,3307000000,-25000000,611000000,-185000000,-1795000000,2044000000,2006000000,2069000000,0,-1980000000,829000000,0,2609000000,0,38000000,1458000000,38399000000,0,2478000000,1414000000,1431000000,0,2478000000,FY2018.FQ4,4
40,0.38,2019-04-30,2019-03,37.1,1400000000,31535000000,4116000000,1.5,1.48,3343000000,12000000,-137000000,-181000000,805000000,2157000000,2119000000,2145000000,0,624000000,1244000000,0,414000000,0,38000000,2282000000,34878000000,0,2099000000,1417000000,1436000000,0,2099000000,FY2019.FQ1,1
41,0.38,2019-08-01,2019-06,38.53,1400000000,31471000000,3407000000,1.68,1.66,4589000000,15000000,-524000000,-195000000,364000000,2418000000,2381000000,2403000000,0,169000000,2487000000,0,271000000,0,37000000,2927000000,36060000000,0,2102000000,1420000000,1438000000,0,2102000000,FY2019.FQ2,2
42,0.38,2019-10-29,2019-09,37.48,1428784000,31161000000,3309000000,1.62,1.6,4312000000,40000000,-271000000,-206000000,169000000,2351000000,2313000000,2311000000,0,-37000000,2304000000,0,315000000,0,38000000,2582000000,35473000000,0,2008000000,1428000000,1442000000,0,2008000000,FY2019.FQ3,3
43,0.38,2020-02-05,2019-12,36.6,1400000000,29098000000,3286000000,-0.17,-0.17,1728000000,-2000000,163000000,-200000000,-909000000,-194000000,-232000000,-192000000,0,-1109000000,-554000000,0,1308000000,0,38000000,-355000000,30826000000,0,2282000000,1430000000,1439000000,0,2282000000,FY2019.FQ4,4
44,0.38,2020-05-06,2020-03,20.78,1432277000,30082000000,3308000000,0.17,0.17,2627000000,8000000,-357000000,-193000000,311000000,294000000,247000000,286000000,0,118000000,657000000,0,-132000000,0,47000000,643000000,32709000000,0,1970000000,1433000000,1440000000,0,1970000000,FY2020.FQ1,1
45,0.0,2020-07-29,2020-06,25.3,1400000000,16682000000,3265000000,-0.56,-0.56,96000000,22000000,112000000,-303000000,413000000,-758000000,-806000000,-780000000,0,110000000,-1214000000,0,212000000,0,48000000,-892000000,16778000000,0,1310000000,1432000000,1432000000,0,1310000000,FY2020.FQ2,2
46,0.0,2020-11-05,2020-09,29.59,1400000000,29428000000,3162000000,2.8,2.78,6052000000,27000000,-887000000,-327000000,499000000,4045000000,4005000000,4018000000,0,172000000,4424000000,0,309000000,0,40000000,4905000000,35480000000,0,1628000000,1432000000,1439000000,0,1628000000,FY2020.FQ3,3
47,0.0,2021-02-10,2020-12,41.64,1400000000,32621000000,3080000000,1.95,1.93,4897000000,49000000,-642000000,-275000000,-982000000,2846000000,2801000000,2797000000,0,-1257000000,2767000000,0,1929000000,0,45000000,3439000000,37518000000,0,2130000000,1436000000,1451000000,0,2130000000,FY2020.FQ4,4
48,0.0,2021-05-05,2021-03,57.46,1400000000,27394000000,3015000000,2.06,2.03,5080000000,8000000,-1177000000,-250000000,799000000,3022000000,2976000000,3014000000,0,549000000,3277000000,0,365000000,0,46000000,4191000000,32474000000,0,1803000000,1447000000,1464000000,0,1803000000,FY2021.FQ1,1
49,0.0,2021-08-04,2021-06,59.17,1500000000,29160000000,3018000000,1.92,1.9,5007000000,57000000,-971000000,-243000000,784000000,2836000000,2790000000,2779000000,0,541000000,2882000000,0,327000000,0,46000000,3750000000,34167000000,0,2125000000,1451000000,1468000000,0,2125000000,FY2021.FQ2,2
50,0.0,2021-10-27,2021-09,52.71,1500000000,22986000000,3081000000,1.64,1.62,3793000000,34000000,-152000000,-230000000,800000000,2420000000,2375000000,2386000000,0,570000000,1645000000,0,323000000,0,45000000,2538000000,26779000000,0,2148000000,1452000000,1467000000,0,2148000000,FY2021.FQ3,3
51,0.0,2022-02-02,2021-12,58.63,1500000000,29586000000,2937000000,1.17,1.15,3998000000,-25000000,-471000000,-227000000,-2237000000,1741000000,1696000000,1766000000,0,-2464000000,1520000000,0,3181000000,0,45000000,2237000000,33584000000,0,2478000000,1454000000,1471000000,0,2478000000,FY2021.FQ4,4
52,0.0,2022-04-27,2022-03,43.74,1500000000,31279000000,2891000000,1.36,1.35,4700000000,131000000,28000000,-226000000,517000000,2939000000,1987000000,2807000000,0,291000000,2196000000,1000000,292000000,0,952000000,2779000000,35979000000,0,2504000000,1458000000,1470000000,0,2504000000,FY2022.FQ1,1
53,0.0,2022-07-26,2022-06,31.76,1500000000,31350000000,2856000000,1.14,1.14,4409000000,50000000,-490000000,-234000000,295000000,1692000000,1666000000,1642000000,0,61000000,2116000000,0,-45000000,0,26000000,2132000000,35759000000,0,2293000000,1458000000,1465000000,0,2293000000,FY2022.FQ2,2
54,0.09,2022-10-25,2022-09,32.09,1400000000,36020000000,2773000000,2.26,2.25,5868000000,53000000,-845000000,-259000000,598000000,3305000000,3279000000,3252000000,0,339000000,3391000000,0,367000000,0,26000000,4097000000,41888000000,0,2477000000,1448000000,1457000000,0,2477000000,FY2022.FQ3,3
55,0.09,2023-01-31,2022-12,33.64,1400000000,37105000000,2770000000,1.41,1.4,6003000000,-8000000,-580000000,-268000000,-950000000,1999000000,1984000000,2008000000,0,-1218000000,2610000000,-1000000,1196000000,0,15000000,2588000000,43108000000,0,3393000000,1415000000,1424000000,0,3393000000,FY2022.FQ4,4
56,0.09,2023-04-25,2023-03,36.68,1400000000,34859000000,2812000000,1.7,1.69,5126000000,49000000,-428000000,-234000000,409000000,2395000000,2368000000,2347000000,0,175000000,2579000000,-1000000,21000000,0,27000000,2775000000,39985000000,0,2547000000,1396000000,1402000000,0,2547000000,FY2023.FQ1,1
57,0.09,2023-07-25,2023-06,38.56,1400000000,39400000000,2934000000,1.83,1.83,5347000000,59000000,-522000000,-226000000,358000000,2566000000,2539000000,2507000000,0,132000000,2789000000,0,108000000,0,27000000,3029000000,44747000000,0,2558000000,1385000000,1389000000,0,2558000000,FY2023.FQ2,2
58,0.09,2023-10-24,2023-09,32.97,1400000000,38775000000,2992000000,2.21,2.2,5356000000,70000000,-470000000,-229000000,453000000,3064000000,3038000000,2994000000,0,224000000,3012000000,0,228000000,0,26000000,3464000000,44131000000,0,2344000000,1372000000,1378000000,0,2344000000,FY2023.FQ3,3
59,0.09,2024-01-30,2023-12,35.92,1200000000,39670000000,3150000000,1.61,1.6,3309000000,108000000,858000000,-222000000,-110000000,2101000000,2075000000,1994000000,0,-332000000,918000000,-1000000,550000000,0,26000000,1136000000,42979000000,0,2391000000,1304000000,1306000000,0,2391000000,FY2023.FQ4,4
60,0.12,2024-04-23,2024-03,45.35,1100000000,37102000000,2798000000,2.57,2.56,5912000000,27000000,-762000000,-219000000,302000000,2980000000,2971000000,2953000000,0,83000000,3737000000,0,-105000000,0,9000000,3715000000,43014000000,0,2175000000,1155000000,1162000000,0,2175000000,FY2024.FQ1,1
61,0.12,2024-07-23,2024-06,46.46,1100000000,41724000000,3486000000,2.57,2.55,6244000000,57000000,-767000000,-206000000,60000000,2933000000,2918000000,2876000000,0,-146000000,3872000000,0,-83000000,0,15000000,3643000000,47968000000,0,2372000000,1136000000,1147000000,0,2372000000,FY2024.FQ2,2
62,0.12,2024-10-22,2024-09,44.84,1100000000,42360000000,2872000000,2.71,2.68,6396000000,48000000,-709000000,-206000000,394000000,3056000000,3029000000,3008000000,0,188000000,3651000000,0,-122000000,0,27000000,3717000000,48756000000,0,2745000000,1116000000,1131000000,0,2745000000,FY2024.FQ3,3
63,0.12,2025-01-28,2024-12,53.27,1000000000,42851000000,3233000000,-1.4,-1.4,4851000000,-87000000,-318000000,-215000000,211000000,-2961000000,-1725000000,-2875000000,0,-4000000,1522000000,1000000,-4075000000,0,-1236000000,-2557000000,47702000000,0,3329000000,1052000000,1075000000,0,3329000000,FY2024.FQ4,4
64,0.12,2025-05-01,2025-03,47.03,966280000,38682000000,2934000000,3.4,3.35,5338000000,-69000000,-719000000,-152000000,310000000,2784000000,3361000000,2853000000,0,158000000,3353000000,0,61000000,0,-577000000,3572000000,44020000000,0,1985000000,988000000,1002000000,0,1985000000,FY2025.FQ1,1
